TTGAAAGTCCG -> TGAAAGTCCGT
CCTAATTTACA -> CTAATTTACAA
TGTTACATTTT -> GTTACATTTTG
CGAAGCCCTGG -> GAAGCCCTGGG
CCACCGAACTC -> CACCGAACTCC
GAGATGCAAGG -> AGATGCAAGGA
GTGTCCCGGAA -> TGTCCCGGAAT
AGCCCTGGGGG -> GCCCTGGGGGA
GAGCACTTATT -> AGCACTTATTT
ATGATCTCACT -> TGATCTCACTC
CACGTTAGTGT -> ACGTTAGTGTA
CGCAGCCTCCG -> GCAGCCTCCGT
TAATCATTCCG -> AATCATTCCGG
TGGGCCCCACT -> GGGCCCCACTG
ACTGGGCCCCA -> CTGGGCCCCAC
GCAGTCACATG -> CAGTCACATGG
AGTCCTGGCAA -> GTCCTGGCAAT
GTGGATGCTCA -> TGGATGCTCAT
CACTCCGGCGC -> ACTCCGGCGCA
CCATCACTCGA -> CATCACTCGAA
ATATCTAAGCG -> TATCTAAGCGG
TTCATCGTTGA -> TCATCGTTGAA
GACCACAGACC -> ACCACAGACCG
ACGCGACTGGG -> CGCGACTGGGC
GAAAAGCATAT -> AAAAGCATATA
GCAGGTTACTC -> CAGGTTACTCT
TTGCTCCCCGA -> TGCTCCCCGAT
AATCGTACGCT -> ATCGTACGCTT
TGCGCTGTCGC -> GCGCTGTCGCT
ACCGGCTCCAA -> CCGGCTCCAAC
TCCATTTTATG -> CCATTTTATGA
GCTCCAACTGC -> CTCCAACTGCC
TCTGACCAGAA -> CTGACCAGAAG
TGCAGCATACC -> GCAGCATACCA
GAATCTCCCTG -> AATCTCCCTGC
GATAGCAGCAG -> ATAGCAGCAGT
GGTCTTTCAGC -> GTCTTTCAGCC
CCGATGTCAAA -> CGATGTCAAAC
TCAACGTTAGC -> CAACGTTAGCA
CACCTTTCAGA -> ACCTTTCAGAT
AGTTCTGTGGG -> GTTCTGTGGGG
CTTCTTCTTTC -> TTCTTCTTTCG
CTACGGTCATT -> TACGGTCATTG
AATTATAGGGG -> ATTATAGGGGC
ACGTTAGTGTA -> CGTTAGTGTAC
CATCCCCTATA -> ATCCCCTATAG
ACCGGCACTTC -> CCGGCACTTCA
ACCCTGTTGTA -> CCCTGTTGTAC
AAATTATAGGG -> AATTATAGGGG
GCGGGCAGCTT -> CGGGCAGCTTG
GCGCCGCGTCT -> CGCCGCGTCTA
AGGCTACGCTA -> GGCTACGCTAG
ATCGTCCAAGA -> TCGTCCAAGAA
TCCGTGAGGGA -> CCGTGAGGGAT
CCCCTCTAGAC -> CCCTCTAGACG
GGAAGGGTTGC -> GAAGGGTTGCG
GGCCCCACTGG -> GCCCCACTGGG
AAGCATATAAC -> AGCATATAACA
GCTTATAAGGG -> CTTATAAGGGA
TCAGATGGCTT -> CAGATGGCTTA
ATATAACACAA -> TATAACACAAG
GCCAGGGGGTA -> CCAGGGGGTAT
CTGCAGGAAGG -> TGCAGGAAGGG
GGCGCATTGCG -> GCGCATTGCGA
AGGGTTGCGCT -> GGGTTGCGCTG
GAGTTCTGTGG -> AGTTCTGTGGG
AAGCACCGGCT -> AGCACCGGCTC
CGCCCGCATCG -> GCCCGCATCGA
TGCCGGGAGTA -> GCCGGGAGTAG
GTACTGGTTCC -> TACTGGTTCCT
TGTTGGCCTCT -> GTTGGCCTCTG
GTGTTGGCCTC -> TGTTGGCCTCT
CAGCATACCAG -> AGCATACCAGC
CGAACTCCCGT -> GAACTCCCGTA
GCGACACTGCG -> CGACACTGCGC
TATGAGATGGA -> ATGAGATGGAG
CAAGCGGTCTG -> AAGCGGTCTGA
ACTCCTCACTC -> CTCCTCACTCC
AAAGTACCGAT -> AAGTACCGATA
GCGCTGGCTCC -> CGCTGGCTCCA
CAACGGTTAGG -> AACGGTTAGGC
GGGAGGGTAAG -> GGAGGGTAAGC
TGCGGTGCCGC -> GCGGTGCCGCA
TAAAAGTACCG -> AAAAGTACCGA
AGGAAGGGTTG -> GGAAGGGTTGC
CATCGGACCTC -> ATCGGACCTCG
GTCCAATGCGC -> TCCAATGCGCC
ACAGGCCCGCT -> CAGGCCCGCTC
AGCTCCGCGAC -> GCTCCGCGACT
ACCATGCGCGG -> CCATGCGCGGG
AGATGGTTAAC -> GATGGTTAACT
ATGCCCTGAAA -> TGCCCTGAAAT
AATAATCATTC -> ATAATCATTCC
GTGCGATATCC -> TGCGATATCCA
CTCCGCGACTC -> TCCGCGACTCG
CTGTTGTACTG -> TGTTGTACTGG
GTTAACTTATG -> TTAACTTATGC
CGGTGCCGCAT -> GGTGCCGCATC
ACCGATAGGTT -> CCGATAGGTTA
CCGTTGTCGGA -> CGTTGTCGGAC
TTCGACCTATT -> TCGACCTATTT
CTACGCGGGGG -> TACGCGGGGGG
AGTCCGGTATC -> GTCCGGTATCC
GGGCTTGAACG -> GGCTTGAACGC
TCCGATGTCAA -> CCGATGTCAAA
GGTAAATTATA -> GTAAATTATAG
GAGGGTAAGCC -> AGGGTAAGCCG
TCCGGTATCCG -> CCGGTATCCGC
CTTTTGTCCAA -> TTTTGTCCAAT
GCTCAGGACAA -> CTCAGGACAAT
CGTAGCTGCCC -> GTAGCTGCCCT
GGATGTCGGCA -> GATGTCGGCAC
CGTAATTGCGG -> GTAATTGCGGT
GACCGGCTGAA -> ACCGGCTGAAT
TCCATATGTTC -> CCATATGTTCG
CGCCCGGACCT -> GCCCGGACCTG
CCGTGAGGGAT -> CGTGAGGGATC
AATGCAAGAAC -> ATGCAAGAACA
TGAGATGGAGA -> GAGATGGAGAA
GAGTCACCCCT -> AGTCACCCCTC
GTACAGGTAGA -> TACAGGTAGAC
CCCTTACCCTC -> CCTTACCCTCG
AGCAGTCCTGG -> GCAGTCCTGGC
TCCCCTGTGTC -> CCCCTGTGTCC
ACAGCAAGGAC -> CAGCAAGGACC
CTCCTTCAGCA -> TCCTTCAGCAA
CGGACCTGTTA -> GGACCTGTTAC
TCCGTTGTCGG -> CCGTTGTCGGA
GATCCCATTAT -> ATCCCATTATG
TCGGCGACACT -> CGGCGACACTG
CGGCGACACTG -> GGCGACACTGC
AAGTCCTAGAG -> AGTCCTAGAGA
GGATGCTCATG -> GATGCTCATGT
GGCTTATAAGG -> GCTTATAAGGG
CAAGGGTTCTT -> AAGGGTTCTTA
TCGACCTATTT -> CGACCTATTTA
TGGGAGGGTAA -> GGGAGGGTAAG
GGTATCCGCTC -> GTATCCGCTCC
CGCATCGAAGC -> GCATCGAAGCC
GACAGAAGCCC -> ACAGAAGCCCA
ACAAGCCTCCT -> CAAGCCTCCTA
CACATGGTGTT -> ACATGGTGTTG
CTGCGTACACG -> TGCGTACACGG
ATGCGGCACTT -> TGCGGCACTTA
AGCCCGTGGCT -> GCCCGTGGCTT
CACTAACTACC -> ACTAACTACCG
AGCCCATCGTA -> GCCCATCGTAA
CGATAGCAGCA -> GATAGCAGCAG
GAATCGCACAG -> AATCGCACAGC
AATTGCGGTGC -> ATTGCGGTGCC
CAGTTATAATT -> AGTTATAATTA
ATGCAAGAACA -> TGCAAGAACAT
TATCCATTTTA -> ATCCATTTTAT
CGGGCAGCGAA -> GGGCAGCGAAA
GACGGGAGCAC -> ACGGGAGCACT
ACTCTTCGATA -> CTCTTCGATAG
GTCGGACTGAG -> TCGGACTGAGG
GCCCCACTGGG -> CCCCACTGGGA
TACTGTCACGC -> ACTGTCACGCG
TTTCGTAAGCT -> TTCGTAAGCTC
AAGCCTCCTAT -> AGCCTCCTATC
AGAAAAATATG -> GAAAAATATGC
TCTAAGCGGGC -> CTAAGCGGGCA
TCAAACACTAA -> CAAACACTAAC
TTCTGCGTACA -> TCTGCGTACAC
AGCACAGGCCC -> GCACAGGCCCG
CACTTCACCCC -> ACTTCACCCCG
TACGAGGAAAT -> ACGAGGAAATT
TTAGCCCGTGG -> TAGCCCGTGGC
CTGGGAGGGTA -> TGGGAGGGTAA
CCATGTCAACA -> CATGTCAACAC
TGCCGATTTAG -> GCCGATTTAGT
ATCCTAAAGCA -> TCCTAAAGCAC
CGGACCTCGCA -> GGACCTCGCAG
CTATAGCTACG -> TATAGCTACGC
AATCTCAACCT -> ATCTCAACCTG
AACACAAGCCT -> ACACAAGCCTC
TGAAATGTGTG -> GAAATGTGTGG
CAAGCCTCCTA -> AAGCCTCCTAT
CCGTTGGCCAC -> CGTTGGCCACG
GTACACGCTCT -> TACACGCTCTA
ATCGTAATTGC -> TCGTAATTGCG
TTCAGATGGCT -> TCAGATGGCTT
GCACAGGCCCG -> CACAGGCCCGC
GAAAGTCCGTT -> AAAGTCCGTTG
TGCCGGAGATG -> GCCGGAGATGC
AGTCTGACGCC -> GTCTGACGCCC
AATGTCTATGC -> ATGTCTATGCC
GGTGCAGCATA -> GTGCAGCATAC
CTTGGTCGCCC -> TTGGTCGCCCG
CTTCACCCCGG -> TTCACCCCGGA
TGGGGACAGAA -> GGGGACAGAAG
CGGTTATAGCC -> GGTTATAGCCA
GCGACGGGAGC -> CGACGGGAGCA
ACTACCGGCAC -> CTACCGGCACT
ACTCTTTACGG -> CTCTTTACGGC
GGGAGCGCGCC -> GGAGCGCGCCC
GCGAAAGATAA -> CGAAAGATAAG
GTGAGGGATCC -> TGAGGGATCCT
AAATGTGTGGA -> AATGTGTGGAT
TAAAGCACCGG -> AAAGCACCGGC
TTATCCATTTT -> TATCCATTTTA
CCACAGACCGG -> CACAGACCGGC
TAGCCAGGTAC -> AGCCAGGTACG
AAGGAGTTTAG -> AGGAGTTTAGC
GCGTACACGGA -> CGTACACGGAG
GGCAGTCCAAT -> GCAGTCCAATG
CTCTGTGAATC -> TCTGTGAATCT
GCCCTTACCCT -> CCCTTACCCTC
AGTGCGCTGGC -> GTGCGCTGGCT
GGGGGAGTTCT -> GGGGAGTTCTG
TACGATGAAGC -> ACGATGAAGCT
CCTTGCTCGCA -> CTTGCTCGCAG
AGTAGTGCGCC -> GTAGTGCGCCT
TGGAATGTATG -> GGAATGTATGA
CCTAAAGCACC -> CTAAAGCACCG
GGGACCATGAT -> GGACCATGATC
TAGTGTAGGGG -> AGTGTAGGGGT
CTTTCAGATGG -> TTTCAGATGGC
GTGCAGCATAC -> TGCAGCATACC
CCCCTATAGCT -> CCCTATAGCTA
TACATTTTGGA -> ACATTTTGGAA
ACAGCACAACG -> CAGCACAACGG
GGAACACTTTC -> GAACACTTTCA
GATGCTCATGT -> ATGCTCATGTC
TTACAAGTCCT -> TACAAGTCCTA
CTTAAGTAGTG -> TTAAGTAGTGC
TAAGCCGTTGG -> AAGCCGTTGGC
ACCGGCTGAAT -> CCGGCTGAATC
GCACGTGCCGA -> CACGTGCCGAT
ACTCGAAGAAA -> CTCGAAGAAAA
TTCTTATTAAC -> TCTTATTAACT
GGTCTCCCCTG -> GTCTCCCCTGT
TTGCTCGCAGC -> TGCTCGCAGCC
AGGCCACCGGG -> GGCCACCGGGA
TACTGCCTTGC -> ACTGCCTTGCT
AGAACTTGCTC -> GAACTTGCTCC
CGCTCCTTCAG -> GCTCCTTCAGC
TTAATATCTAA -> TAATATCTAAG
GCGGTGCCGCA -> CGGTGCCGCAT
CTCTAGACGCA -> TCTAGACGCAG
TGAGGGATCCT -> GAGGGATCCTA
CCGGAATTATA -> CGGAATTATAA
TGCATTCCAGG -> GCATTCCAGGT
CGTTAGTGTAC -> GTTAGTGTACT
AGACTGCCGAT -> GACTGCCGATT
GCACTTATTTT -> CACTTATTTTT
ATCAAACTACG -> TCAAACTACGG
AGGTAGACTCA -> GGTAGACTCAC
GTCTGCCGTGC -> TCTGCCGTGCA
GGCTCCATCAC -> GCTCCATCACT
GTTTAGCTCCG -> TTTAGCTCCGC
TGAAACCACCG -> GAAACCACCGA
CTGCCGATTTA -> TGCCGATTTAG
ATCTAAGCGGG -> TCTAAGCGGGC
CATTCCGGTTA -> ATTCCGGTTAT
TGTCGGCACGT -> GTCGGCACGTG
CTGGGGGAGTT -> TGGGGGAGTTC
CGAATTAATCT -> GAATTAATCTC
TCTGACGCCCC -> CTGACGCCCCA
CCATATGTTCG -> CATATGTTCGA
TTATAGCCAGG -> TATAGCCAGGT
GAGAACAGTCC -> AGAACAGTCCG
TGACCTCGAGG -> GACCTCGAGGC
TGTCCAATGTC -> GTCCAATGTCT
GGGTAAATTAT -> GGTAAATTATA
GTAGTTGACCT -> TAGTTGACCTC
GGAAATTCTGC -> GAAATTCTGCG
CTTATAAGGGA -> TTATAAGGGAC
TCAACACTCTT -> CAACACTCTTT
TCCTCACTCCG -> CCTCACTCCGG
GCGGAGTGCGC -> CGGAGTGCGCT
TCGGGATAGAA -> CGGGATAGAAC
GCGCCCGGACC -> CGCCCGGACCT
CAGGGAGTGAT -> AGGGAGTGATC
TGAAGCTTAAG -> GAAGCTTAAGT
TGATCTCACTC -> GATCTCACTCG
TAAATGCAAGA -> AAATGCAAGAA
CTGACAGCACA -> TGACAGCACAA
AGGCTCAGGAC -> GGCTCAGGACA
AATCGTCCAAG -> ATCGTCCAAGA
CATTCACGCGA -> ATTCACGCGAC
TAGGGAGCGCG -> AGGGAGCGCGC
TTAGTGTACTA -> TAGTGTACTAA
CCCTGAAATGT -> CCTGAAATGTG
GTATGGATTCT -> TATGGATTCTT
GGGAGTGATCC -> GGAGTGATCCA
TTCGCCAGATC -> TCGCCAGATCC
CCTTTTGTCCA -> CTTTTGTCCAA
CTGTGAATCTC -> TGTGAATCTCC
GATCCAAGGAG -> ATCCAAGGAGG
GCCCGCATCGA -> CCCGCATCGAA
AGGGTACACGC -> GGGTACACGCT
CTGCCGTGCAT -> TGCCGTGCATC
TTTATGAGAAC -> TTATGAGAACC
AGAACGATAGT -> GAACGATAGTC
GATCAGTTATA -> ATCAGTTATAA
TAGTGTACTAA -> AGTGTACTAAA
GGAGCACTTAT -> GAGCACTTATT
CGTTGGCCACG -> GTTGGCCACGT
TCTATGCCCCA -> CTATGCCCCAT
AATCCAGCGGG -> ATCCAGCGGGT
CGATATCCAGC -> GATATCCAGCG
GCGGGGGGCAG -> CGGGGGGCAGT
TTGTCCAATGT -> TGTCCAATGTC
CGTGACTTGAG -> GTGACTTGAGT
ACAAGTCCTAG -> CAAGTCCTAGA
AGTTTAATATC -> GTTTAATATCT
TGTGAATCTCC -> GTGAATCTCCC
GATCTCACTCG -> ATCTCACTCGT
ATTCTTCTTCT -> TTCTTCTTCTT
AAGAACTTGCT -> AGAACTTGCTC
GAGATCCTAAC -> AGATCCTAACC
CTAGCCTGCAT -> TAGCCTGCATT
GGACCTCGCAG -> GACCTCGCAGT
GCAGTCCAATG -> CAGTCCAATGC
AATGTATGAAG -> ATGTATGAAGT
CAGCCGCGAAA -> AGCCGCGAAAA
CCTCCTATCGG -> CTCCTATCGGC
TAGGTTAGGGT -> AGGTTAGGGTA
GCCGGGAGTAG -> CCGGGAGTAGT
CCAAGGAGGCG -> CAAGGAGGCGT
TGCAGTAAAAG -> GCAGTAAAAGT
CCCATCGTAAT -> CCATCGTAATT
TCTGCCGTGCA -> CTGCCGTGCAT
CTTCGATCCCA -> TTCGATCCCAT
GGGATAATCCA -> GGATAATCCAG
CGCCCTCGGCA -> GCCCTCGGCAC
AGGCGTCGTGA -> GGCGTCGTGAG
AGCGAAAGATA -> GCGAAAGATAA
TCCGCTCCATC -> CCGCTCCATCG
TCTAGACGCTA -> CTAGACGCTAA
TTACCCTCGGG -> TACCCTCGGGA
GACACTGCGCC -> ACACTGCGCCT
CCGCATCGAAG -> CGCATCGAAGC
TTATTAACTGC -> TATTAACTGCC
ACCAATTACGA -> CCAATTACGAG
TCAGCAAACGA -> CAGCAAACGAG
CAGACCGGCTG -> AGACCGGCTGA
ATGAAGCTTAA -> TGAAGCTTAAG
ATAAGGGACCA -> TAAGGGACCAT
CAGCACAACGG -> AGCACAACGGT
GTTGACCGTCA -> TTGACCGTCAG
AAAAGTACCGA -> AAAGTACCGAT
AGCTGCCCTAA -> GCTGCCCTAAA
GCATACCAGCA -> CATACCAGCAG
TCTGACAGCAC -> CTGACAGCACA
AAGTCGTATGG -> AGTCGTATGGA
CAACTGCCGGG -> AACTGCCGGGA
TTCTGTGGGGA -> TCTGTGGGGAC
TAGCTGCCCTA -> AGCTGCCCTAA
CTCCCTGCATG -> TCCCTGCATGG
CGAGGAAATTC -> GAGGAAATTCT
TCATTCACGCG -> CATTCACGCGA
CATCACTCGAA -> ATCACTCGAAG
TGCCTAATTTA -> GCCTAATTTAC
GCCGGACCACA -> CCGGACCACAG
TTATGAGAACC -> TATGAGAACCA
GGGGGGCAGTC -> GGGGGCAGTCC
GGGGAGTTCTG -> GGGAGTTCTGT
CTATGTGTTTT -> TATGTGTTTTA
GAAATTCTGCG -> AAATTCTGCGT
AAACCTTACTG -> AACCTTACTGT
CTATCGGCGAC -> TATCGGCGACA
GAAACCACCGA -> AAACCACCGAA
ACAGACCGGCT -> CAGACCGGCTG
GAACATGGGCA -> AACATGGGCAT
GCAGCTTGATT -> CAGCTTGATTC
GAGGAGCAAGG -> AGGAGCAAGGG
ATCACTCGAAG -> TCACTCGAAGA
AACCACCGAAC -> ACCACCGAACT
GCCTGCATTCC -> CCTGCATTCCA
AAACACTAACT -> AACACTAACTA
AGCGGGCAGCT -> GCGGGCAGCTT
CACGTGCCGAT -> ACGTGCCGATC
TGGTTAACTTA -> GGTTAACTTAT
GTCTATGCCCC -> TCTATGCCCCA
CGCCCCAGACT -> GCCCCAGACTC
GGTACGATGAA -> GTACGATGAAG
CCTAGAGATCC -> CTAGAGATCCT
CCTGTTGTACT -> CTGTTGTACTA,CTGTTGTACTG
CTCAACCTGTT -> TCAACCTGTTG
CACTGGGAGGG -> ACTGGGAGGGT
TAATCCAGCGG -> AATCCAGCGGG
AATCTCCCTGC -> ATCTCCCTGCA
GCATCGACGCG -> CATCGACGCGA
TATCCAGCGCC -> ATCCAGCGCCC
GCTTGAACGCA -> CTTGAACGCAC
CAGGGGGTATG -> AGGGGGTATGC
ATAACACAAGC -> TAACACAAGCC
CCCCAGACTCA -> CCCAGACTCAA
CCCGAACACTT -> CCGAACACTTA
CACAGACCGGC -> ACAGACCGGCT
GCAGGAAGGGT -> CAGGAAGGGTT
AGGCAGGTTAC -> GGCAGGTTACT
AAAGAAGAACT -> AAGAAGAACTT
AATATGCCCGT -> ATATGCCCGTA
TCGCTAATCAC -> CGCTAATCACT
CAGCTTGATTC -> AGCTTGATTCC
CGGTCTGACCA -> GGTCTGACCAG
TATTTACCCTG -> ATTTACCCTGT
CACTGTGTTCA -> ACTGTGTTCAT
TGTCACGCGAC -> GTCACGCGACC
TCGATAGCAGC -> CGATAGCAGCA
CAGCAGTCCTG -> AGCAGTCCTGG
CCGTCAGAGGC -> CGTCAGAGGCT
CGATAGTCCGC -> GATAGTCCGCC
CCTGCATTCCA -> CTGCATTCCAG
CTCTTTACGGC -> TCTTTACGGCG
TTACGGCGGGA -> TACGGCGGGAT
GGGAACACTTT -> GGAACACTTTC
GGTTAGGGTAC -> GTTAGGGTACA
ATACCAGCAGA -> TACCAGCAGAA
TTTACGGCGGG -> TTACGGCGGGA
CAATTACGAGG -> AATTACGAGGA
ACGAGGAAATT -> CGAGGAAATTC
GCCCGCTCCTT -> CCCGCTCCTTC
GTACACGGAGT -> TACACGGAGTA
GCTCCGCGACT -> CTCCGCGACTC
AAGGACCGTAG -> AGGACCGTAGC
GGGGTATGCCC -> GGGTATGCCCT
ACTAGGATGAG -> CTAGGATGAGC
AACGCACACGT -> ACGCACACGTG
CGGGATAGAAC -> GGGATAGAACG
CTGTTGTACTA -> TGTTGTACTAC
CGAAAAGCATA -> GAAAAGCATAT
GACGCGAGGTC -> ACGCGAGGTCT
AAACCACCGAA -> AACCACCGAAC
CCCTCTAGACG -> CCTCTAGACGC
ACCTTTCAGAT -> CCTTTCAGATG
AACGATAGTCC -> ACGATAGTCCG
GCGACTCGACA -> CGACTCGACAG
AGAGATGGTTA -> GAGATGGTTAA
TGTGTCCCGGA -> GTGTCCCGGAA
CATCGAAGCCC -> ATCGAAGCCCT
TCCTTAGCCCG -> CCTTAGCCCGT
AGCGGGTGCAG -> GCGGGTGCAGC
CACCGGCTCCA -> ACCGGCTCCAA
TGCCGCATCAA -> GCCGCATCAAA
ACTGCCTTGCT -> CTGCCTTGCTC
AGGCCCGCTCC -> GGCCCGCTCCT
CAGTCCGGTAT -> AGTCCGGTATC
AAACTACGGTC -> AACTACGGTCA
TGCGATATCCA -> GCGATATCCAG
GATTCTTCTTC -> ATTCTTCTTCT
GGTCATTGAAC -> GTCATTGAACC
TGACCGTCAGA -> GACCGTCAGAG
CTGGCTCCATC -> TGGCTCCATCA
GAACACTTATC -> AACACTTATCC
GCACCGGCTCC -> CACCGGCTCCA
ATGTCAAACAC -> TGTCAAACACT
GCTGGCTCCAT -> CTGGCTCCATC
TAGCAGCAGTC -> AGCAGCAGTCC
TACACGGAGTA -> ACACGGAGTAC
GCCCGGACCTG -> CCCGGACCTGT
ACCAGCAGAAT -> CCAGCAGAATG
TTTGTCCAATG -> TTGTCCAATGT
AGAATCGCACA -> GAATCGCACAG
CTAAACCTTAC -> TAAACCTTACT
CAGCCGGACCA -> AGCCGGACCAC
TGCTCCCCGAT -> GCTCCCCGATT
AACTGCCGGGA -> ACTGCCGGGAG
CCTCACTCCGG -> CTCACTCCGGC
GTCTGACGCCC -> TCTGACGCCCC
CAAGTCCTAGA -> AAGTCCTAGAG
GGAGTGCGCTG -> GAGTGCGCTGG
TGGACTTGGCA -> GGACTTGGCAC
TGAACCCGAAC -> GAACCCGAACA
GGTGTTGGCCT -> GTGTTGGCCTC
CTAGACGCAGA -> TAGACGCAGAC
GTATGCATTAC -> TATGCATTACT
CGACGGGAGCA -> GACGGGAGCAC
CCGATCAGTTA -> CGATCAGTTAT
CTCCATCGGAC -> TCCATCGGACC
CATTCCAGGTG -> ATTCCAGGTGG
AGCAGAATGGG -> GCAGAATGGGA
AGAACCAATTA -> GAACCAATTAC
CCAATTACGAG -> CAATTACGAGG
CACGGAGTACA -> ACGGAGTACAG
AAGCTCTATGC -> AGCTCTATGCC
GGATTCTTCTT -> GATTCTTCTTC
GAATCGTACGC -> AATCGTACGCT
TTAAATGCAGA -> TAAATGCAGAC
TAGGGGTAAAT -> AGGGGTAAATT
GGCTTGAACGC -> GCTTGAACGCA
CTGACCAGAAG -> TGACCAGAAGA
GATCCTAACCG -> ATCCTAACCGA
CCGAATTAATC -> CGAATTAATCT
TTCCTTAGCCC -> TCCTTAGCCCG
TAAATGCAGAC -> AAATGCAGACA
ATCCAGCGGGT -> TCCAGCGGGTG
TTATAATCCAT -> TATAATCCATA
GTAGGGGTAAA -> TAGGGGTAAAT
ATCGTACGCTT -> TCGTACGCTTC
CGCCTTTTGTC -> GCCTTTTGTCC
ACTCACTCAAT -> CTCACTCAATC
AGTACCGATAG -> GTACCGATAGG
GAGGAAATTCT -> AGGAAATTCTG
AAGAACATGGG -> AGAACATGGGC
CTTACTGTTAT -> TTACTGTTATA
CTAAAGCACCG -> TAAAGCACCGG
ACCGAACTCCC -> CCGAACTCCCG
AGACGCAGACT -> GACGCAGACTG
AGCTACGCGGG -> GCTACGCGGGG
AGCCGAATTAA -> GCCGAATTAAT
TACGGTCATTG -> ACGGTCATTGA
TGAATCGTACG -> GAATCGTACGC
CCCCTGTGTCC -> CCCTGTGTCCC
ACCACCGAACT -> CCACCGAACTC
CTCCATCACTC -> TCCATCACTCG
TGAGAACCAAT -> GAGAACCAATT
TCTTCGATAGC -> CTTCGATAGCA
ATTCGCCAGAT -> TTCGCCAGATC
CCTGCAGGAAG -> CTGCAGGAAGG
CGGCACGTGCC -> GGCACGTGCCG
CGTATGGATTC -> GTATGGATTCT
ACCCCTCTAGA -> CCCCTCTAGAC
TCCGGCGCATT -> CCGGCGCATTG
GGGTACACGCT -> GGTACACGCTC
CGCTAATCACT -> GCTAATCACTG
TCACTCGAAGA -> CACTCGAAGAA
TCTATGCCGGA -> CTATGCCGGAG
GCAGACATTCG -> CAGACATTCGC
TACCGATAGGT -> ACCGATAGGTT
GGAATGTATGA -> GAATGTATGAA
CTAGACGCTAA -> TAGACGCTAAC
CCGCATCAAAC -> CGCATCAAACT
TTACTGTTATA -> TACTGTTATAT
CGCATTGCGAC -> GCATTGCGACG
AGTGATCCAAG -> GTGATCCAAGG
GACAATCAAGC -> ACAATCAAGCA
CTTACCTGTAT -> TTACCTGTATG
CGGCACTTCAC -> GGCACTTCACC
TGTCTATGCCC -> GTCTATGCCCC
AAGGGACCATG -> AGGGACCATGA
ACGCACACGTG -> CGCACACGTGA
CGATAGGTTAG -> GATAGGTTAGG
TCCCGTAGAGG -> CCCGTAGAGGA
GTATGAAGTCG -> TATGAAGTCGT
GGGATACTGCC -> GGATACTGCCT
ATCCTAACCGA -> TCCTAACCGAC
AGAACAGTCCG -> GAACAGTCCGG
GCTCCTTCAGC -> CTCCTTCAGCA
CATTACTGTCA -> ATTACTGTCAC
ACTTGAGTTTA -> CTTGAGTTTAA
CTAGGATGAGC -> TAGGATGAGCC
TTGAACCCGAA -> TGAACCCGAAC
TATGGATTCTT -> ATGGATTCTTC
GCATCGAAGCC -> CATCGAAGCCC
GAATGAAACCA -> AATGAAACCAC
TATAATCCATA -> ATAATCCATAT
AGCCGTTGGCC -> GCCGTTGGCCA
CAGGTTACTCT -> AGGTTACTCTT
GCTGTCGCTAA -> CTGTCGCTAAT
CCAACTAGGAT -> CAACTAGGATG
GGCGGGATAAT -> GCGGGATAATC
AATTAGCACTT -> ATTAGCACTTG
CAGAATGGGAA -> AGAATGGGAAC
TATAACACAAG -> ATAACACAAGC
GGGCAGCGAAA -> GGCAGCGAAAG
GAATGTATGAA -> AATGTATGAAG
AACTACGGTCA -> ACTACGGTCAT
AGCTCTATGCC -> GCTCTATGCCG
AACTCCCGTAG -> ACTCCCGTAGA
TCTAGCCTGCA -> CTAGCCTGCAT
GCGGGCAGCGA -> CGGGCAGCGAA
GACTGAGGCTA -> ACTGAGGCTAC
TTAGCACTTGG -> TAGCACTTGGT
ATCCCCTATAG -> TCCCCTATAGC
GGTTCTTATTA -> GTTCTTATTAA
GCCCGTATTTC -> CCCGTATTTCT
ATCTCACTCGT -> TCTCACTCGTT
GCATGGGGTCT -> CATGGGGTCTC
GACTTGGCACC -> ACTTGGCACCT
GTAATTGCGGT -> TAATTGCGGTG
CGAGTCTGACG -> GAGTCTGACGC
TATGAGAACCA -> ATGAGAACCAA
CAGGACAATCA -> AGGACAATCAA
TCGAGGCAGGT -> CGAGGCAGGTT
CCTAAATGCAA -> CTAAATGCAAG
AGAAGAATCGC -> GAAGAATCGCA
TTGGAATGTAT -> TGGAATGTATG
AAGAAAAATAT -> AGAAAAATATG
GTAGACTCACT -> TAGACTCACTC
CAGCAGAATGG -> AGCAGAATGGG
TATGAAGTCGT -> ATGAAGTCGTA
GGGCATCGACG -> GGCATCGACGC
ACTACCGAACA -> CTACCGAACAA
CGCAGTCTGCC -> GCAGTCTGCCG
CTGCCCTAAAT -> TGCCCTAAATG
TTCGATAGCAG -> TCGATAGCAGC
CTTTCAGCCCT -> TTTCAGCCCTT
GATCCTAAAGC -> ATCCTAAAGCA
CCCTGTTGTAC -> CCTGTTGTACT
CGACTCGACAG -> GACTCGACAGC
GTTGTACTACC -> TTGTACTACCG
TGCATTACTGT -> GCATTACTGTC
ATCCAAGGAGG -> TCCAAGGAGGC
TCTTCTTTCGT -> CTTCTTTCGTA
ATGCGCGGGCA -> TGCGCGGGCAG
GGCAATGGGCG -> GCAATGGGCGG
AGTTATAATTA -> GTTATAATTAG
GATATCCAGCG -> ATATCCAGCGC
CCGAGTCTGAC -> CGAGTCTGACG
TCCAAGGAGGC -> CCAAGGAGGCG
CTCTATGTGTT -> TCTATGTGTTT
AGGGACCATGA -> GGGACCATGAT
TACGCTTCGAT -> ACGCTTCGATC
CACTCTTTACG -> ACTCTTTACGG
ACTTGCTCCCC -> CTTGCTCCCCG
GACTCAACGTT -> ACTCAACGTTA
AACAAAGAAGA -> ACAAAGAAGAA
GTTCCCCAGGG -> TTCCCCAGGGA
AGTTGACCTCG -> GTTGACCTCGA
CTAAATGCAAG -> TAAATGCAAGA
TTTAGCTCCGC -> TTAGCTCCGCG
AGACCGGCTGA -> GACCGGCTGAA
CCTTACTGTTA -> CTTACTGTTAT
GGCAGGTTACT -> GCAGGTTACTC
CGGGCAGCTTG -> GGGCAGCTTGA
CTGAATCGTAC -> TGAATCGTACG
GAGCCGAATTA -> AGCCGAATTAA
TCCAGCGGGTG -> CCAGCGGGTGC
CGACTGGGCCC -> GACTGGGCCCC
GCAGAATGGGA -> CAGAATGGGAA
GAAGCCCTGGG -> AAGCCCTGGGG
ACTCAATCGTC -> CTCAATCGTCC
CTATGCCGGAG -> TATGCCGGAGA
CCTCGAGGCAG -> CTCGAGGCAGG
TCCAATGTCTA -> CCAATGTCTAT
CTCCCGTAGAG -> TCCCGTAGAGG
GAGCAAGGGTT -> AGCAAGGGTTC
CGGAGTGCGCT -> GGAGTGCGCTG
AGTCCTAGAGA -> GTCCTAGAGAT
AGGGAGTGATC -> GGGAGTGATCC
ACTGCCGGGAG -> CTGCCGGGAGT
ATAAGGCCACC -> TAAGGCCACCG
TCCAAGAATGA -> CCAAGAATGAA
GCTGAATCGTA -> CTGAATCGTAC
TGCAGGAAGGG -> GCAGGAAGGGT
TGTACTAAACC -> GTACTAAACCT
TCATGTCGCCC -> CATGTCGCCCG
GGTTACTCTTC -> GTTACTCTTCG
TTACTCTTCGA -> TACTCTTCGAT
GCGGGATAATC -> CGGGATAATCC
TCCTGGCAATG -> CCTGGCAATGG
ACTGGGAGGGT -> CTGGGAGGGTA
TCGTAATTGCG -> CGTAATTGCGG
TGGCACCTTTC -> GGCACCTTTCA
GAAAAATATGC -> AAAAATATGCC
CTCGGCACTCC -> TCGGCACTCCT
CGGAGTACAGG -> GGAGTACAGGT
CCGGGAGTAGT -> CGGGAGTAGTT
GAACAGTCCGG -> AACAGTCCGGT
ACTGGACTTGG -> CTGGACTTGGC
CCCATGTCAAC -> CCATGTCAACA
AACTTATGCGG -> ACTTATGCGGC
GTCCGCCAGGG -> TCCGCCAGGGG
CGAGGTCTTTC -> GAGGTCTTTCA
CAGATGGCTTA -> AGATGGCTTAT
CTTATTTTTCC -> TTATTTTTCCG
GGAGGGTAAGC -> GAGGGTAAGCC
GGGCAGCTTGA -> GGCAGCTTGAT
TCACCCCGGAT -> CACCCCGGATG
TCGTTGAAAGT -> CGTTGAAAGTC
AATTACGAGGA -> ATTACGAGGAA
CGACTGGACTT -> GACTGGACTTG
CCTGTATGCAT -> CTGTATGCATT
CCCAGGGAGTG -> CCAGGGAGTGA
CCAAGCGGTCT -> CAAGCGGTCTG
GCCCCATGTCA -> CCCCATGTCAA
GGATACTGCCT -> GATACTGCCTT
GCTAACAGCCG -> CTAACAGCCGG
ATTGAACCCGA -> TTGAACCCGAA
AGACGCTAACA -> GACGCTAACAG
CATGTCAACAC -> ATGTCAACACT
AGAGGCTGCAG -> GAGGCTGCAGT
GCTCCATCGGA -> CTCCATCGGAC
AGGTCTTTCAG -> GGTCTTTCAGC
CTGAAATGTGT -> TGAAATGTGTG
AAAGATAAGGC -> AAGATAAGGCC
GTGCGCCTTTT -> TGCGCCTTTTG
CATATGTTCGA -> ATATGTTCGAC
CATACCAGCAG -> ATACCAGCAGA
TATTTTTCCGC -> ATTTTTCCGCC
ACCACAGACCG -> CCACAGACCGG
AGGTACGATGA -> GGTACGATGAA
TGACAGCACAA -> GACAGCACAAC
CCCTCGGGATA -> CCTCGGGATAG
GCTGCCCTAAA -> CTGCCCTAAAT
TTTCCGCCCGC -> TTCCGCCCGCA
GTTATAGCCAG -> TTATAGCCAGG
AGTCACCCCTC -> GTCACCCCTCT
TGTTCATTCAC -> GTTCATTCACG
AGCGCGCCCGG -> GCGCGCCCGGA
GAGCGCGCCCG -> AGCGCGCCCGG
CAGTCACATGG -> AGTCACATGGT
TTCCGAGTCTG -> TCCGAGTCTGA
GTTTAATATCT -> TTTAATATCTA
CATTATGAGAT -> ATTATGAGATG
TCAGGACAATC -> CAGGACAATCA
ACATCTGACAG -> CATCTGACAGC
CAGCGGGTGCA -> AGCGGGTGCAG
GGCAGCGAAAG -> GCAGCGAAAGA
AGCCTGCATTC -> GCCTGCATTCC
GGCGACACTGC -> GCGACACTGCG
ATTACTGTCAC -> TTACTGTCACG
GGTACACGCTC -> GTACACGCTCT
GTCGCTAATCA -> TCGCTAATCAC
AACCAATTACG -> ACCAATTACGA
AGGGATCCTAA -> GGGATCCTAAA
TCCTAGAGATC -> CCTAGAGATCC
GCCTGAAACAT -> CCTGAAACATC
TACAGGTAGAC -> ACAGGTAGACT
CGGGAGCACTT -> GGGAGCACTTA
GTGAGTCACCC -> TGAGTCACCCC
CGGCTGAATCG -> GGCTGAATCGT
ACAGAAGCCCA -> CAGAAGCCCAT
TATGTTCGACC -> ATGTTCGACCT
GAGATGGAGAA -> AGATGGAGAAC
TAGTTGACCTC -> AGTTGACCTCG
CCTTAGCCCGT -> CTTAGCCCGTG
TAGCACTTGGT -> AGCACTTGGTC
TCTGTGAATCT -> CTGTGAATCTC
GATCTGTCTAG -> ATCTGTCTAGA
TAACACAAGCC -> AACACAAGCCT
CGTCGTGAGTC -> GTCGTGAGTCA
TCAAGCACAGG -> CAAGCACAGGC
GGACTTCCTGC -> GACTTCCTGCA
TTACCTGTATG -> TACCTGTATGC
CAGACTGCCGA -> AGACTGCCGAT
AAGGGTTGCGC -> AGGGTTGCGCT
ACCGTAGCTGC -> CCGTAGCTGCC
GGAGTAGTTGA -> GAGTAGTTGAC
AGATCCAACTA -> GATCCAACTAG
GCTAGTGCGAT -> CTAGTGCGATA
GAGGCAGGTTA -> AGGCAGGTTAC
CAGATCCAACT -> AGATCCAACTA
AAGTACCGATA -> AGTACCGATAG
GTCACGCGACC -> TCACGCGACCA
ATTTTGGAATG -> TTTTGGAATGT
CGATCTGTCTA -> GATCTGTCTAG
TGTGTTCATTC -> GTGTTCATTCA
GTCTTTCAGCC -> TCTTTCAGCCC
CTGCATGGGGT -> TGCATGGGGTC
AGAATGAAACC -> GAATGAAACCA
CCCCATGTCAA -> CCCATGTCAAC
GCAGCATACCA -> CAGCATACCAG
CAGCAAACGAG -> AGCAAACGAGA
CTGCAGTAAAA -> TGCAGTAAAAG
CTTAGCCCGTG -> TTAGCCCGTGG
CCGATTCCGAG -> CGATTCCGAGT
CAGTCTGCCGT -> AGTCTGCCGTG
CGTGCCGATCA -> GTGCCGATCAG
TTGGCCTCTGT -> TGGCCTCTGTG
CCTTCAGCAAA -> CTTCAGCAAAC
ATTATAGGGGC -> TTATAGGGGCT
AAATGCAAGAA -> AATGCAAGAAC
ATTTACAAGTC -> TTTACAAGTCC
CGCGAAAAGCA -> GCGAAAAGCAT
CCCGTATTTCT -> CCGTATTTCTG
CGCTAACAGCC -> GCTAACAGCCG
GTTCTGTGGGG -> TTCTGTGGGGA
CATTTTATGAG -> ATTTTATGAGA
ACATTTTGGAA -> CATTTTGGAAT
GGAGTTTAGCT -> GAGTTTAGCTC
TACTGTTATAT -> ACTGTTATATA
ATGCGCCGCGT -> TGCGCCGCGTC
ACATTCGCCAG -> CATTCGCCAGA
ATTATGAGATG -> TTATGAGATGG
CAGGCCCGCTC -> AGGCCCGCTCC
GCGCGGGCAGC -> CGCGGGCAGCG
CAAGGAGTTTA -> AAGGAGTTTAG
GCAAGGAGTTT -> CAAGGAGTTTA
GGTCTGACCAG -> GTCTGACCAGA
ATGGTGTTGGC -> TGGTGTTGGCC
GTTATAATTAG -> TTATAATTAGC
CTGCATTCCAG -> TGCATTCCAGG
GGGTGCAGCAT -> GGTGCAGCATA
GGTTGCGCTGT -> GTTGCGCTGTC
CTCCCCGATTC -> TCCCCGATTCC
TCACGCGACTG -> CACGCGACTGG
ATATGCCCGTA -> TATGCCCGTAT
GGAGCGCGCCC -> GAGCGCGCCCG
TTGCGACGGGA -> TGCGACGGGAG
GAGTAGTTGAC -> AGTAGTTGACC
CCAGATCCAAC -> CAGATCCAACT
TGGTTCCTTAG -> GGTTCCTTAGC
TTGCGGTGCCG -> TGCGGTGCCGC
AGGCTGCAGTA -> GGCTGCAGTAA
GAACACTTTCA -> AACACTTTCAT
TGGGGTCTCCC -> GGGGTCTCCCC
CACTGCGCCTG -> ACTGCGCCTGA
CGAGAGGACTT -> GAGAGGACTTC
GAAACATCTGA -> AAACATCTGAC
ACTGTTATATA -> CTGTTATATAG
ACAGTCCGGTA -> CAGTCCGGTAT
TGGTCGCCCGT -> GGTCGCCCGTC
TGCCGATCAGT -> GCCGATCAGTT
CTACCGGCACT -> TACCGGCACTT
CAAACACTAAC -> AAACACTAACT
CAAACTACGGT -> AAACTACGGTC
GGACTGAGGCT -> GACTGAGGCTA
GCCCTGAAATG -> CCCTGAAATGT
GCAGCCTCCGT -> CAGCCTCCGTG
AAGCGGGCAGC -> AGCGGGCAGCT
GTACCGATAGG -> TACCGATAGGT
TCCGGTTATAG -> CCGGTTATAGC
ACTTATTTTTC -> CTTATTTTTCC
GGATAGAACGA -> GATAGAACGAT
TGTTTTAAATG -> GTTTTAAATGC
AAACATCTGAC -> AACATCTGACA
TGAATCTCCCT -> GAATCTCCCTG
TAAGCTCTATG -> AAGCTCTATGC
GCGAAAAGCAT -> CGAAAAGCATA
ATCCCATTATG -> TCCCATTATGA
ATGGATTCTTC -> TGGATTCTTCT
TAGAGGAGCAA -> AGAGGAGCAAG
TCTCAACCTGT -> CTCAACCTGTT
TCCCCAGGGAG -> CCCCAGGGAGT
GTAGAGGAGCA -> TAGAGGAGCAA
CTCGTTGACCG -> TCGTTGACCGT
ATCGCACAGCA -> TCGCACAGCAA
CAAGGACCGTA -> AAGGACCGTAG
GCGATATCCAG -> CGATATCCAGC
GAACTTGCTCC -> AACTTGCTCCC
GGCTACGCTAG -> GCTACGCTAGT
GCCCGTCATCC -> CCCGTCATCCC
TAGGGGCTTGA -> AGGGGCTTGAA
TCAATCGTCCA -> CAATCGTCCAA
GAGAACCAATT -> AGAACCAATTA
CTGAAACATCT -> TGAAACATCTG
TCCCGGAATTA -> CCCGGAATTAT
ATTAGCACTTG -> TTAGCACTTGG
GAATAATCATT -> AATAATCATTC
TCTTTCGTAAG -> CTTTCGTAAGC
TCCATCACTCG -> CCATCACTCGA
CTGGTTCCTTA -> TGGTTCCTTAG
TGGGAACACTT -> GGGAACACTTT
TAATTTACAAG -> AATTTACAAGT
TGCAAGAACAT -> GCAAGAACATG
CCGTATTTCTG -> CGTATTTCTGT
CCAGAAGAATC -> CAGAAGAATCG
GAAATGTGTGG -> AAATGTGTGGA
CCGGCTCCAAC -> CGGCTCCAACT
AATCCATATGT -> ATCCATATGTT
TCCAACTAGGA -> CCAACTAGGAT
GCATTGCGACG -> CATTGCGACGG
TCATCCCCTAT -> CATCCCCTATA
AGGTTAGGGTA -> GGTTAGGGTAC
CCCATTATGAG -> CCATTATGAGA
ACTTACCTGTA -> CTTACCTGTAT
GGGATCCTAAA -> GGATCCTAAAG
ATCGACGCGAG -> TCGACGCGAGG
TTAACTGCCTA -> TAACTGCCTAA
GCTCCATCACT -> CTCCATCACTC
AAGAATCGCAC -> AGAATCGCACA
TCCAAGCGGTC -> CCAAGCGGTCT
TCAGTTATAAT -> CAGTTATAATT
TGAACGCACAC -> GAACGCACACG
CTTCCTGCAGG -> TTCCTGCAGGA
TTCCGCCCGCA -> TCCGCCCGCAT
TTATAAGGGAC -> TATAAGGGACC
TCCGCCAGGGG -> CCGCCAGGGGG
CCTGTGTCCCG -> CTGTGTCCCGG
CCCCAGGGAGT -> CCCAGGGAGTG
AGATGGCTTAT -> GATGGCTTATA
CCATCGGACCT -> CATCGGACCTC
AGTCGTATGGA -> GTCGTATGGAT
TAACTGCCTAA -> AACTGCCTAAT
CCTGTTACATT -> CTGTTACATTT
CATGATCTCAC -> ATGATCTCACT
TACCCTGTTGT -> ACCCTGTTGTA
TCGCCCGTCAT -> CGCCCGTCATC
AGATCCTAACC -> GATCCTAACCG
GTATGCCCTGA -> TATGCCCTGAA
GACAGCCGCGA -> ACAGCCGCGAA
GTGTTCATTCA -> TGTTCATTCAC
GACCGTAGCTG -> ACCGTAGCTGC
GGCGTCGTGAG -> GCGTCGTGAGT
TCGACGCGAGG -> CGACGCGAGGT
GTCCGTTGTCG -> TCCGTTGTCGG
CGCCAGATCCA -> GCCAGATCCAA
ATCCATATGTT -> TCCATATGTTC
CCCTATAGCTA -> CCTATAGCTAC
TAATCACTGTG -> AATCACTGTGT
TGTGGATGCTC -> GTGGATGCTCA
GATAGTCCGCC -> ATAGTCCGCCA
CACTCGTTGAC -> ACTCGTTGACC
TCCATCGGACC -> CCATCGGACCT
CCGACTGGACT -> CGACTGGACTT
CACAAGCCTCC -> ACAAGCCTCCT
ATTGCGACGGG -> TTGCGACGGGA
ACCGTCAGAGG -> CCGTCAGAGGC
GACGCTAACAG -> ACGCTAACAGC
TATGCATTACT -> ATGCATTACTG
CACGCGACCAT -> ACGCGACCATG
TTTACAAGTCC -> TTACAAGTCCT
GCCGAATTAAT -> CCGAATTAATC
TCTGCGTACAC -> CTGCGTACACG
CCAGCAGAATG -> CAGCAGAATGG
GTCAGAGGCTG -> TCAGAGGCTGC
CGGTATCCGCT -> GGTATCCGCTC
AACGTTAGCAG -> ACGTTAGCAGT
GGAGCAAGGGT -> GAGCAAGGGTT
GTCCGGTATCC -> TCCGGTATCCG
GGTAAGCCGTT -> GTAAGCCGTTG
GCCTCTGTGAA -> CCTCTGTGAAT
GCAAGAACATG -> CAAGAACATGG
CAGCCCTTACC -> AGCCCTTACCC
GACTGGACTTG -> ACTGGACTTGG
AGCAGTCACAT -> GCAGTCACATG
ACTCAACGTTA -> CTCAACGTTAG
CGACACTGCGC -> GACACTGCGCC
CGCGCCCGGAC -> GCGCCCGGACC
CATCCAAGCGG -> ATCCAAGCGGT
CGACCTATTTA -> GACCTATTTAC
CAAGGAGGCGT -> AAGGAGGCGTC
AGTCCGCCAGG -> GTCCGCCAGGG
AGCCCTTACCC -> GCCCTTACCCT
TGCCCGTATTT -> GCCCGTATTTC
ACAGCCGGACC -> CAGCCGGACCA
TAGGGTACACG -> AGGGTACACGC
ACGGCGGGATA -> CGGCGGGATAA
CGTCTAGCCTG -> GTCTAGCCTGC
AATGCGCCGCG -> ATGCGCCGCGT
GCATTCCAGGT -> CATTCCAGGTG
TTTACCCTGTT -> TTACCCTGTTG
AGTAGTTGACC -> GTAGTTGACCT
CTTGCTCGCAG -> TTGCTCGCAGC
ACGCAGACTGC -> CGCAGACTGCC
CACTCAATCGT -> ACTCAATCGTC
CACCGGGATAC -> ACCGGGATACT
GAGGGATCCTA -> AGGGATCCTAA
TCGTCCAAGAA -> CGTCCAAGAAT
ACTGCCTAATT -> CTGCCTAATTT
ACCTCGCAGTC -> CCTCGCAGTCT
TCAGCCCTTAC -> CAGCCCTTACC
ATTTACCCTGT -> TTTACCCTGTT
TACCAGCAGAA -> ACCAGCAGAAT
CCGCCAGGGGG -> CGCCAGGGGGT
AGTTTAGCTCC -> GTTTAGCTCCG
TGTTCGACCTA -> GTTCGACCTAT
TTGAACGCACA -> TGAACGCACAC
CCAATGCGCCG -> CAATGCGCCGC
CCAGCGCCCTC -> CAGCGCCCTCG
TCATTGAACCC -> CATTGAACCCG
CTCACTCCGGC -> TCACTCCGGCG
TTAGGGTACAC -> TAGGGTACACG
CACTTTCATCG -> ACTTTCATCGT
GACCAGAAGAA -> ACCAGAAGAAT
GTCGTGAGTCA -> TCGTGAGTCAC
TTTAATATCTA -> TTAATATCTAA
TTCTTTCGTAA -> TCTTTCGTAAG
TCACATGGTGT -> CACATGGTGTT
ACGCGACCATG -> CGCGACCATGC
AGCACTTATTT -> GCACTTATTTT
AACCTGTTGTA -> ACCTGTTGTAC
ATGCAAGGAGT -> TGCAAGGAGTT
CCCCACTGGGA -> CCCACTGGGAG
ACTTGGCACCT -> CTTGGCACCTT
CATCGACGCGA -> ATCGACGCGAG
AACGAGAGGAC -> ACGAGAGGACT
CGTGAGGGATC -> GTGAGGGATCC
GTCCAAGAATG -> TCCAAGAATGA
TTCATTCACGC -> TCATTCACGCG
ACTAAACCTTA -> CTAAACCTTAC
GCAGCAGTCCT -> CAGCAGTCCTG
AGCTTAAGTAG -> GCTTAAGTAGT
TACTGGTTCCT -> ACTGGTTCCTT
TCGTATGGATT -> CGTATGGATTC
AATTAATCTCA -> ATTAATCTCAA
CGTTGAAAGTC -> GTTGAAAGTCC
CCCGATTCCGA -> CCGATTCCGAG
GGCACTTACCT -> GCACTTACCTG
TTATAATTAGC -> TATAATTAGCA
GGGGTCTCCCC -> GGGTCTCCCCT
AAGCCGTTGGC -> AGCCGTTGGCC
GGAGAACAGTC -> GAGAACAGTCC
ACGCGAGGTCT -> CGCGAGGTCTT
AGTAAAAGTAC -> GTAAAAGTACC
GGCACCTTTCA -> GCACCTTTCAG
AATCACTGTGT -> ATCACTGTGTT
TCATTCCGGTT -> CATTCCGGTTA
AATTATAATCC -> ATTATAATCCA
AGGACTTCCTG -> GGACTTCCTGC
TGCCGTGCATC -> GCCGTGCATCC
CATGGGCATCG -> ATGGGCATCGA
TGCATGGGGTC -> GCATGGGGTCT
CAGTAAAAGTA -> AGTAAAAGTAC
TACCTGTATGC -> ACCTGTATGCA
AATGTGTGGAT -> ATGTGTGGATG
AGGACCGTAGC -> GGACCGTAGCT
AAGCTTAAGTA -> AGCTTAAGTAG
GACTCGACAGC -> ACTCGACAGCC
CTCCTCACTCC -> TCCTCACTCCG
CGTTAGCAGTC -> GTTAGCAGTCA
CTTTACGGCGG -> TTTACGGCGGG
TTTAAATGCAG -> TTAAATGCAGA
ATGCCCGTATT -> TGCCCGTATTT
CTGTTATATAG -> TGTTATATAGA
CTTGATTCCGA -> TTGATTCCGAT
ATGGTTAACTT -> TGGTTAACTTA
ATTTCTGTTCC -> TTTCTGTTCCC
CAATGCGCCGC -> AATGCGCCGCG
CCAACTGCCGG -> CAACTGCCGGG
AGGAAATTCTG -> GGAAATTCTGC
CACTTGGTCGC -> ACTTGGTCGCC
GCCCTAAATGC -> CCCTAAATGCA
CAATCGTCCAA -> AATCGTCCAAG
AACACTTATCC -> ACACTTATCCA
TACCGGCACTT -> ACCGGCACTTC
ACACTTATCCA -> CACTTATCCAT
GCCAGATCCAA -> CCAGATCCAAC
ATTACGAGGAA -> TTACGAGGAAA
TCCCCTATAGC -> CCCCTATAGCT
TCACTCAATCG -> CACTCAATCGT
TGTCGCCCGAA -> GTCGCCCGAAT
CGTTGTCGGAC -> GTTGTCGGACT
CTTGAACGCAC -> TTGAACGCACA
CGCTTCGATCC -> GCTTCGATCCC
AGACTCACTCA -> GACTCACTCAA
TGTTGTACTGG -> GTTGTACTGGT
GAGGCGTCGTG -> AGGCGTCGTGA
CGCGAGGTCTT -> GCGAGGTCTTT
CGCAGACTGCC -> GCAGACTGCCG
TGTGTTTTAAA -> GTGTTTTAAAT
GTCATTGAACC -> TCATTGAACCC
CGTGCATCCAA -> GTGCATCCAAG
CGCTGGCTCCA -> GCTGGCTCCAT
GGGGCAGTCCA -> GGGCAGTCCAA
CCAAGAATGAA -> CAAGAATGAAA
TGCGCCTGAAA -> GCGCCTGAAAC
AAATATGCCCG -> AATATGCCCGT
CCCGGATGTCG -> CCGGATGTCGG
GAAGTCGTATG -> AAGTCGTATGG
ATTCCGATGTC -> TTCCGATGTCA
CGCCCGTCATC -> GCCCGTCATCC
GGCCCGCTCCT -> GCCCGCTCCTT
TGCAAGGAGTT -> GCAAGGAGTTT
TTCACCCCGGA -> TCACCCCGGAT
AATCATTCCGG -> ATCATTCCGGT
CTGGGCCCCAC -> TGGGCCCCACT
TATAAGGGACC -> ATAAGGGACCA
CTATTTACCCT -> TATTTACCCTG
GACCATGATCT -> ACCATGATCTC
ATGTGTTTTAA -> TGTGTTTTAAA
TTCTTCTTCTT -> TCTTCTTCTTT
GCGCCCTCGGC -> CGCCCTCGGCA
AAGCCCTGGGG -> AGCCCTGGGGG
GTTCATTCACG -> TTCATTCACGC
GAAAGATAAGG -> AAAGATAAGGC
GCACTTCACCC -> CACTTCACCCC
TATGCCCGTAT -> ATGCCCGTATT
TGCAGACATTC -> GCAGACATTCG
GCACACGTGAC -> CACACGTGACT
ACAATCAAGCA -> CAATCAAGCAC
CAGAAGCCCAT -> AGAAGCCCATC
CTTGCTCCCCG -> TTGCTCCCCGA
GCAAGGGTTCT -> CAAGGGTTCTT
GACTGGGCCCC -> ACTGGGCCCCA
GAACTCCCGTA -> AACTCCCGTAG
GCACAACGGTT -> CACAACGGTTA
AGGGGCTTGAA -> GGGGCTTGAAC
ACACTAACTAC -> CACTAACTACC
ATGGGCGGAGT -> TGGGCGGAGTG
TGTTGTACTAC -> GTTGTACTACC
CAAGCACAGGC -> AAGCACAGGCC
TCCGAGTCTGA -> CCGAGTCTGAC
ACGCTAGTGCG -> CGCTAGTGCGA
CCACGTTAGTG -> CACGTTAGTGT
CTGTCTAGACG -> TGTCTAGACGC
ATCGTTGAAAG -> TCGTTGAAAGT
GGACCACAGAC -> GACCACAGACC
TGTGGGGACAG -> GTGGGGACAGA
CATATAACACA -> ATATAACACAA
CGCTGTCGCTA -> GCTGTCGCTAA
GTAGCTGCCCT -> TAGCTGCCCTA
ATGCCCCATGT -> TGCCCCATGTC
CGCCCGAATAA -> GCCCGAATAAT
AGCAGCAGTCC -> GCAGCAGTCCT
TGAGGCTACGC -> GAGGCTACGCT
TCGCCAGATCC -> CGCCAGATCCA
TACTACCGAAC -> ACTACCGAACA
GGAGGCGTCGT -> GAGGCGTCGTG
AGTCCAATGCG -> GTCCAATGCGC
TTATTTTTCCG -> TATTTTTCCGC
AAAAGCATATA -> AAAGCATATAA
GGATAATCCAG -> GATAATCCAGC
CTCAATCGTCC -> TCAATCGTCCA
GGCTCCAACTG -> GCTCCAACTGC
CCAGGGAGTGA -> CAGGGAGTGAT
TCCTTCAGCAA -> CCTTCAGCAAA
TGCTCATGTCG -> GCTCATGTCGC
ACCCGAACACT -> CCCGAACACTT
TTGAGTTTAAT -> TGAGTTTAATA
ATGGCTTATAA -> TGGCTTATAAG
CGATGTCAAAC -> GATGTCAAACA
GCCGATCAGTT -> CCGATCAGTTA
ATCGAAGCCCT -> TCGAAGCCCTG
CTCGCAGTCTG -> TCGCAGTCTGC
ACTCCCGTAGA -> CTCCCGTAGAG
GGGAGTAGTTG -> GGAGTAGTTGA
GGACCTGTTAC -> GACCTGTTACA
CGGACCACAGA -> GGACCACAGAC
CCTCGCAGTCT -> CTCGCAGTCTG
AAGTCCGTTGT -> AGTCCGTTGTC
ATTAACTGCCT -> TTAACTGCCTA
ATCGGCGACAC -> TCGGCGACACT
CGCACACGTGA -> GCACACGTGAC
AAAAATATGCC -> AAAATATGCCC
GAGTGATCCAA -> AGTGATCCAAG
CTCGAAGAAAA -> TCGAAGAAAAA
GAAGAATCGCA -> AAGAATCGCAC
GGGGGCAGTCC -> GGGGCAGTCCA
ATTTTTCCGCC -> TTTTTCCGCCC
CAGTCCAATGC -> AGTCCAATGCG
TTGACCGTCAG -> TGACCGTCAGA
CGTACGCTTCG -> GTACGCTTCGA
ATGGGCATCGA -> TGGGCATCGAC
GTTAGCAGTCA -> TTAGCAGTCAC
AAATGCAGACA -> AATGCAGACAT
AGTGTACTAAA -> GTGTACTAAAC
CAACGTTAGCA -> AACGTTAGCAG
CAGGTAGACTC -> AGGTAGACTCA
TCCTATCGGCG -> CCTATCGGCGA
GCAGTAAAAGT -> CAGTAAAAGTA
GGTTATAGCCA -> GTTATAGCCAG
GTTGACCTCGA -> TTGACCTCGAG
TGATCCAAGGA -> GATCCAAGGAG
TCCAACTGCCG -> CCAACTGCCGG
ACCTTACTGTT -> CCTTACTGTTA
TGGTGTTGGCC -> GGTGTTGGCCT
CGAAAGATAAG -> GAAAGATAAGG
CCAGACTCAAC -> CAGACTCAACG
TCTCCCCTGTG -> CTCCCCTGTGT
GTCTGACCAGA -> TCTGACCAGAA
TCGTAAGCTCT -> CGTAAGCTCTA
TAGCCTGCATT -> AGCCTGCATTC
GCAAGGACCGT -> CAAGGACCGTA
AGCCTCCTATC -> GCCTCCTATCG
TCAGAGGCTGC -> CAGAGGCTGCA
AGGAGTTTAGC -> GGAGTTTAGCT
CCCGGAATTAT -> CCGGAATTATA
AGCCGCGAAAA -> GCCGCGAAAAG
GTCTAGCCTGC -> TCTAGCCTGCA
CTTCGATAGCA -> TTCGATAGCAG
TTTAGTGTAGG -> TTAGTGTAGGG
TGCCCCATGTC -> GCCCCATGTCA
CCCGGACCTGT -> CCGGACCTGTT
GGAGTACAGGT -> GAGTACAGGTA
CGCACAGCAAG -> GCACAGCAAGG
TGAGTCACCCC -> GAGTCACCCCT
AAAATATGCCC -> AAATATGCCCG
CCGCGACTCGA -> CGCGACTCGAC
CACTTACCTGT -> ACTTACCTGTA
ACTGTCACGCG -> CTGTCACGCGA
ACACGGAGTAC -> CACGGAGTACA
TACCCTCGGGA -> ACCCTCGGGAT
GCATCCAAGCG -> CATCCAAGCGG
CTTGGCACCTT -> TTGGCACCTTT
TTAACTTATGC -> TAACTTATGCG
CGCATCAAACT -> GCATCAAACTA
ACTACGGTCAT -> CTACGGTCATT
TCACGCGACCA -> CACGCGACCAT
TGCGCTGGCTC -> GCGCTGGCTCC
GGCTCAGGACA -> GCTCAGGACAA
CACGCGACTGG -> ACGCGACTGGG
CCTGGGGGAGT -> CTGGGGGAGTT
TACTCTTCGAT -> ACTCTTCGATA
CACAGCAAGGA -> ACAGCAAGGAC
GCCGTGCATCC -> CCGTGCATCCA
GCAGCGAAAGA -> CAGCGAAAGAT
GGATCCTAAAG -> GATCCTAAAGC
CACAGGCCCGC -> ACAGGCCCGCT
ACTAACTACCG -> CTAACTACCGG
TAAATTATAGG -> AAATTATAGGG
CCTAACCGACT -> CTAACCGACTG
CCCCGATTCCG -> CCCGATTCCGA
CGGCTCCAACT -> GGCTCCAACTG
GCCAGGTACGA -> CCAGGTACGAT
GTACGCTTCGA -> TACGCTTCGAT
ATAGCAGCAGT -> TAGCAGCAGTC
CCGGTTATAGC -> CGGTTATAGCC
AGTGCGATATC -> GTGCGATATCC
GGAGTTCTGTG -> GAGTTCTGTGG
ATGAGATGGAG -> TGAGATGGAGA
GATGGAGAACA -> ATGGAGAACAG
TACACGCTCTA -> ACACGCTCTAT
GCGCCTGAAAC -> CGCCTGAAACA
CATGTCGCCCG -> ATGTCGCCCGA
CGGAGATGCAA -> GGAGATGCAAG
ATGCTCATGTC -> TGCTCATGTCG
CCTCCGTGAGG -> CTCCGTGAGGG
AAGCGGTCTGA -> AGCGGTCTGAC
TTGGCACCTTT -> TGGCACCTTTC
CGGTCATTGAA -> GGTCATTGAAC
CCCACTGGGAG -> CCACTGGGAGG
ATCTGACAGCA -> TCTGACAGCAC
GAGGCTACGCT -> AGGCTACGCTA
ATGTCAACACT -> TGTCAACACTC
TCACTCCGGCG -> CACTCCGGCGC
TGAAGTCGTAT -> GAAGTCGTATG
AGGAGGCGTCG -> GGAGGCGTCGT
TATTAACTGCC -> ATTAACTGCCT
GCTTAGGGAGC -> CTTAGGGAGCG
ACAACGGTTAG -> CAACGGTTAGG
ACCGAACAAAG -> CCGAACAAAGA
ATCCGCTCCAT -> TCCGCTCCATC
CGTGGCTTAGG -> GTGGCTTAGGG
TCACTGTGTTC -> CACTGTGTTCA
ACTTCCTGCAG -> CTTCCTGCAGG
ATGTGTGGATG -> TGTGTGGATGC
TATAATTAGCA -> ATAATTAGCAC
AGCCAGGTACG -> GCCAGGTACGA
ATTCTGCGTAC -> TTCTGCGTACA
GCACTTACCTG -> CACTTACCTGT
CCATGCGCGGG -> CATGCGCGGGC
TATGCGGCACT -> ATGCGGCACTT
CCGCTCCATCG -> CGCTCCATCGG
GGGAGCACTTA -> GGAGCACTTAT
CCGGCACTTCA -> CGGCACTTCAC
TCGATCCCATT -> CGATCCCATTA
TGGATTCTTCT -> GGATTCTTCTT
GGGAGTTCTGT -> GGAGTTCTGTG
TCCCCGATTCC -> CCCCGATTCCG
GATACTGCCTT -> ATACTGCCTTG
AGCCTCCGTGA -> GCCTCCGTGAG
TTACGAGGAAA -> TACGAGGAAAT
TAATTAGCACT -> AATTAGCACTT
GCGTCTAGCCT -> CGTCTAGCCTG
CAGGTACGATG -> AGGTACGATGA
TTCCTGCAGGA -> TCCTGCAGGAA
ACATGGGCATC -> CATGGGCATCG
TCCTAAAGCAC -> CCTAAAGCACC
TCATCGTTGAA -> CATCGTTGAAA
CTAGTGCGATA -> TAGTGCGATAT
TTATATAGAGA -> TATATAGAGAT
CTAATCACTGT -> TAATCACTGTG
CCATGATCTCA -> CATGATCTCAC
TATGCCGGAGA -> ATGCCGGAGAT
CACGTGACTTG -> ACGTGACTTGA
ATAGGGGCTTG -> TAGGGGCTTGA
TCAAACTACGG -> CAAACTACGGT
ACCTGTATGCA -> CCTGTATGCAT
GTCATCCCCTA -> TCATCCCCTAT
GTGCCGATCAG -> TGCCGATCAGT
CATGCGCGGGC -> ATGCGCGGGCA
GGGGACAGAAG -> GGGACAGAAGC
GCCTTGCTCGC -> CCTTGCTCGCA
CTGCCTTGCTC -> TGCCTTGCTCG
CTTCAGCAAAC -> TTCAGCAAACG
CACCCCTCTAG -> ACCCCTCTAGA
AACCTTACTGT -> ACCTTACTGTT
AACTAGGATGA -> ACTAGGATGAG
GATGAGCCGAA -> ATGAGCCGAAT
CGTCCAAGAAT -> GTCCAAGAATG
GACGCAGACTG -> ACGCAGACTGC
GCAGACTGCCG -> CAGACTGCCGA
CACAACGGTTA -> ACAACGGTTAG
TGTTCCCCAGG -> GTTCCCCAGGG
CCCTGTGTCCC -> CCTGTGTCCCG
CTGTATGCATT -> TGTATGCATTA
GGCATCGACGC -> GCATCGACGCG
AACTGCCTAAT -> ACTGCCTAATT
AAGTAGTGCGC -> AGTAGTGCGCC
TCACTCGTTGA -> CACTCGTTGAC
ATTAATCTCAA -> TTAATCTCAAC
ACTTATCCATT -> CTTATCCATTT
TCTTCTTCTTT -> CTTCTTCTTTC
TAACTTATGCG -> AACTTATGCGG
GACCTCGCAGT -> ACCTCGCAGTC
TCCAGCGCCCT -> CCAGCGCCCTC
ACGCTCTATGT -> CGCTCTATGTG
AGCACTTGGTC -> GCACTTGGTCG
GATAGAACGAT -> ATAGAACGATA
GGGTAAGCCGT -> GGTAAGCCGTT
TTTCATCGTTG -> TTCATCGTTGA
GCCTAATTTAC -> CCTAATTTACA
GTGCCGCATCA -> TGCCGCATCAA
AGCAAGGACCG -> GCAAGGACCGT
TCCCATTATGA -> CCCATTATGAG
ATCTCCCTGCA -> TCTCCCTGCAT
CGGGAGTAGTT -> GGGAGTAGTTG
AACATGGGCAT -> ACATGGGCATC
CTTCTTTCGTA -> TTCTTTCGTAA
GCCGTTGGCCA -> CCGTTGGCCAC
CTTATGCGGCA -> TTATGCGGCAC
GTGCATCCAAG -> TGCATCCAAGC
AGTCACATGGT -> GTCACATGGTG
TGCGCCGCGTC -> GCGCCGCGTCT
ATTCCGAGTCT -> TTCCGAGTCTG
CACTCCTCACT -> ACTCCTCACTC
TCGGCACTCCT -> CGGCACTCCTC
TTCTTCTTTCG -> TCTTCTTTCGT
GTATTTCTGTT -> TATTTCTGTTC
TAATTGCGGTG -> AATTGCGGTGC
AGGACAATCAA -> GGACAATCAAG
TTGCGCTGTCG -> TGCGCTGTCGC
CCGAACACTTA -> CGAACACTTAT
ACTTTCATCGT -> CTTTCATCGTT
CGAGGCAGGTT -> GAGGCAGGTTA
ACGGTCATTGA -> CGGTCATTGAA
GGCTTAGGGAG -> GCTTAGGGAGC
ATAATTAGCAC -> TAATTAGCACT
TAATATCTAAG -> AATATCTAAGC
AAATTCTGCGT -> AATTCTGCGTA
GTCACATGGTG -> TCACATGGTGT
ATTTAGTGTAG -> TTTAGTGTAGG
AGAGGAGCAAG -> GAGGAGCAAGG
CGCGGGGGGCA -> GCGGGGGGCAG
TGGGCGGAGTG -> GGGCGGAGTGC
GCACTCCTCAC -> CACTCCTCACT
ATATCCAGCGC -> TATCCAGCGCC
GCCCATCGTAA -> CCCATCGTAAT
GAACCAATTAC -> AACCAATTACG
TAGAGATCCTA -> AGAGATCCTAA
TGCCTTGCTCG -> GCCTTGCTCGC
TGTATGCATTA -> GTATGCATTAC
TCGCAGCCTCC -> CGCAGCCTCCG
GCTACGCTAGT -> CTACGCTAGTG
CGCTAGTGCGA -> GCTAGTGCGAT
GTGACTTGAGT -> TGACTTGAGTT
GTTAGTGTACT -> TTAGTGTACTA
TTTGGAATGTA -> TTGGAATGTAT
CCCTAAATGCA -> CCTAAATGCAA
CTCCAACTGCC -> TCCAACTGCCG
TGGATGCTCAT -> GGATGCTCATG
CTAGAGATCCT -> TAGAGATCCTA
GCGGCACTTAC -> CGGCACTTACC
GATGGTTAACT -> ATGGTTAACTT
TCTGTGGGGAC -> CTGTGGGGACA
GAGTACAGGTA -> AGTACAGGTAG
TCAACCTGTTG -> CAACCTGTTGT
GACCTGTTACA -> ACCTGTTACAT
AGCGCCCTCGG -> GCGCCCTCGGC
ATTTTATGAGA -> TTTTATGAGAA
ATATGTTCGAC -> TATGTTCGACC
TTTTTCCGCCC -> TTTTCCGCCCG
CCGAACAAAGA -> CGAACAAAGAA
CAATGGGCGGA -> AATGGGCGGAG
TTCCCCAGGGA -> TCCCCAGGGAG
GTCTCCCCTGT -> TCTCCCCTGTG
GCACTTGGTCG -> CACTTGGTCGC
CAGGAAGGGTT -> AGGAAGGGTTG
TTCCGATGTCA -> TCCGATGTCAA
ATGCCGGAGAT -> TGCCGGAGATG
GAATTAATCTC -> AATTAATCTCA
CACCGAACTCC -> ACCGAACTCCC
TAGACGCTAAC -> AGACGCTAACA
ATGTTCGACCT -> TGTTCGACCTA
ATCTGTCTAGA -> TCTGTCTAGAC
AAAGCATATAA -> AAGCATATAAC
TTACCCTGTTG -> TACCCTGTTGT
TTACATTTTGG -> TACATTTTGGA
CTGTGTTCATT -> TGTGTTCATTC
AGGGGTAAATT -> GGGGTAAATTA
CCGTGCATCCA -> CGTGCATCCAA
GGCTGAATCGT -> GCTGAATCGTA
ACGAGAGGACT -> CGAGAGGACTT
TAGGCTCAGGA -> AGGCTCAGGAC
ATGTATGAAGT -> TGTATGAAGTC
GACTGCCGATT -> ACTGCCGATTT
GTGTGGATGCT -> TGTGGATGCTC
TCCTGCAGGAA -> CCTGCAGGAAG
TTGGCCACGTT -> TGGCCACGTTA
ATAATCATTCC -> TAATCATTCCG
GGCAGCTTGAT -> GCAGCTTGATT
GGGTTCTTATT -> GGTTCTTATTA
CATTCGCCAGA -> ATTCGCCAGAT
GGTTCCTTAGC -> GTTCCTTAGCC
GACCATGCGCG -> ACCATGCGCGG
CTATGCCCCAT -> TATGCCCCATG
GGGTATGCCCT -> GGTATGCCCTG
GACTCACTCAA -> ACTCACTCAAT
ATTATAATCCA -> TTATAATCCAT
ATGGGAACACT -> TGGGAACACTT
ACCTATTTACC -> CCTATTTACCC
CTTGAGTTTAA -> TTGAGTTTAAT
GTTGTCGGACT -> TTGTCGGACTG
ACTGAGGCTAC -> CTGAGGCTACG
CGGCACTCCTC -> GGCACTCCTCA
CGGGATAATCC -> GGGATAATCCA
CTGACGCCCCA -> TGACGCCCCAG
GCTACGCGGGG -> CTACGCGGGGG
ACGATAGTCCG -> CGATAGTCCGC
GGATGAGCCGA -> GATGAGCCGAA
ATCCAACTAGG -> TCCAACTAGGA
GTAAAAGTACC -> TAAAAGTACCG
AGGGTAAGCCG -> GGGTAAGCCGT
GGTGCCGCATC -> GTGCCGCATCA
GGTAGACTCAC -> GTAGACTCACT
ATTCCAGGTGG -> TTCCAGGTGGC
GTCCTGGCAAT -> TCCTGGCAATG
GAGTCTGACGC -> AGTCTGACGCC
TTAAGTAGTGC -> TAAGTAGTGCG
GAGTTTAATAT -> AGTTTAATATC
GACGCCCCAGA -> ACGCCCCAGAC
GCTCGCAGCCT -> CTCGCAGCCTC
CGTACACGGAG -> GTACACGGAGT
CGCGACTCGAC -> GCGACTCGACA
CCGATAGGTTA -> CGATAGGTTAG
GCCGCGAAAAG -> CCGCGAAAAGC
ATTCCGGTTAT -> TTCCGGTTATA
GTTAGGCTCAG -> TTAGGCTCAGG
GATGTCGGCAC -> ATGTCGGCACG
AGAAGAACTTG -> GAAGAACTTGC
CGGCACTTACC -> GGCACTTACCT
TACGGCGGGAT -> ACGGCGGGATA
CGTATTTCTGT -> GTATTTCTGTT
CGGAATTATAA -> GGAATTATAAT
TGTCTAGACGC -> GTCTAGACGCT
CCCGTAGAGGA -> CCGTAGAGGAG
ATGCAGACATT -> TGCAGACATTC
GTCGCCCGTCA -> TCGCCCGTCAT
CCTATAGCTAC -> CTATAGCTACG
TTGACCTCGAG -> TGACCTCGAGG
ACAAAGAAGAA -> CAAAGAAGAAC
TCGAAGCCCTG -> CGAAGCCCTGG
ATGAAGTCGTA -> TGAAGTCGTAT
TACAAGTCCTA -> ACAAGTCCTAG
TGGAGAACAGT -> GGAGAACAGTC
GTTACATTTTG -> TTACATTTTGG
TGATTCCGATG -> GATTCCGATGT
AGTGTAGGGGT -> GTGTAGGGGTA
TGGCTTATAAG -> GGCTTATAAGG
AAACGAGAGGA -> AACGAGAGGAC
GTAAATTATAG -> TAAATTATAGG
GATTTAGTGTA -> ATTTAGTGTAG
TTGTACTGGTT -> TGTACTGGTTC
CTCCGGCGCAT -> TCCGGCGCATT
TCTCCCTGCAT -> CTCCCTGCATG
ACTTGGTCGCC -> CTTGGTCGCCC
CGTCAGAGGCT -> GTCAGAGGCTG
GCCTCCGTGAG -> CCTCCGTGAGG
GCAGTCCTGGC -> CAGTCCTGGCA
CAAAGAAGAAC -> AAAGAAGAACT
GTACGATGAAG -> TACGATGAAGC
CAAGAATGAAA -> AAGAATGAAAC
ATGAGAACCAA -> TGAGAACCAAT
TGGCCACGTTA -> GGCCACGTTAG
CCACCGGGATA -> CACCGGGATAC
ATCCAGCGCCC -> TCCAGCGCCCT
GTTGCGCTGTC -> TTGCGCTGTCG
ACCTGTTGTAC -> CCTGTTGTACT
CGAACACTTAT -> GAACACTTATC
GACTTCCTGCA -> ACTTCCTGCAG
AAGAAGAACTT -> AGAAGAACTTG
GCTCCCCGATT -> CTCCCCGATTC
TTAATCTCAAC -> TAATCTCAACC
GATAGGTTAGG -> ATAGGTTAGGG
ATAGAACGATA -> TAGAACGATAG
GGTCGCCCGTC -> GTCGCCCGTCA
CGGATGTCGGC -> GGATGTCGGCA
ACGGTTAGGCT -> CGGTTAGGCTC
GCAATGGGCGG -> CAATGGGCGGA
GCTAATCACTG -> CTAATCACTGT
AATGCAGACAT -> ATGCAGACATT
TGCTCGCAGCC -> GCTCGCAGCCT
CCTGCATGGGG -> CTGCATGGGGT
AGCGGTCTGAC -> GCGGTCTGACC
GGACCGTAGCT -> GACCGTAGCTG
GCTTCGATCCC -> CTTCGATCCCA
TTATGCGGCAC -> TATGCGGCACT
GAAGGGTTGCG -> AAGGGTTGCGC
TAGCCCGTGGC -> AGCCCGTGGCT
CCGGCTGAATC -> CGGCTGAATCG
CTGTCGCTAAT -> TGTCGCTAATC
CCCAGACTCAA -> CCAGACTCAAC
GACCGTCAGAG -> ACCGTCAGAGG
CCCGCTCCTTC -> CCGCTCCTTCA
GCCTCCTATCG -> CCTCCTATCGG
CGATCAGTTAT -> GATCAGTTATA
CATCGTAATTG -> ATCGTAATTGC
ACTGCCGATTT -> CTGCCGATTTA
TAACAGCCGGA -> AACAGCCGGAC
TTACTGTCACG -> TACTGTCACGC
CAGACATTCGC -> AGACATTCGCC
TAGTGCGCCTT -> AGTGCGCCTTT
GATAAGGCCAC -> ATAAGGCCACC
CTAACTACCGG -> TAACTACCGGC
CACGCTCTATG -> ACGCTCTATGT
GTCCTAGAGAT -> TCCTAGAGATC
GTCCCGGAATT -> TCCCGGAATTA
CGACGCGAGGT -> GACGCGAGGTC
AGTCCGTTGTC -> GTCCGTTGTCG
GTTCTTATTAA -> TTCTTATTAAC
TAAACCTTACT -> AAACCTTACTG
CGGCGCATTGC -> GGCGCATTGCG
CGGCGGGATAA -> GGCGGGATAAT
TTATGAGATGG -> TATGAGATGGA
TTTCAGATGGC -> TTCAGATGGCT
GAGGACTTCCT -> AGGACTTCCTG
TCTATGTGTTT -> CTATGTGTTTT
AACGGTTAGGC -> ACGGTTAGGCT
GAAGAAAAATA -> AAGAAAAATAT
TGTCAACACTC -> GTCAACACTCT
CTGGCAATGGG -> TGGCAATGGGC
CTCCGTGAGGG -> TCCGTGAGGGA
TAGCTACGCGG -> AGCTACGCGGG
AGAGGACTTCC -> GAGGACTTCCT
TAGTGCGATAT -> AGTGCGATATC
ACGGGAGCACT -> CGGGAGCACTT
AATCAAGCACA -> ATCAAGCACAG
TATGCCCCATG -> ATGCCCCATGT
CTGCCTAATTT -> TGCCTAATTTA
TATCTAAGCGG -> ATCTAAGCGGG
CTCATGTCGCC -> TCATGTCGCCC
CCCCGGATGTC -> CCCGGATGTCG
CTCGAGGCAGG -> TCGAGGCAGGT
GCGACCATGCG -> CGACCATGCGC
ATCAGTTATAA -> TCAGTTATAAT
CAGCCTCCGTG -> AGCCTCCGTGA
GCCGCGTCTAG -> CCGCGTCTAGC
CTGCCGGGAGT -> TGCCGGGAGTA
CAGCGCCCTCG -> AGCGCCCTCGG
ACGCGGGGGGC -> CGCGGGGGGCA
GAATTATAATC -> AATTATAATCC
AATTTACAAGT -> ATTTACAAGTC
GTGAATCTCCC -> TGAATCTCCCT
TGGCTTAGGGA -> GGCTTAGGGAG
GGGACAGAAGC -> GGACAGAAGCC
AGAAGCCCATC -> GAAGCCCATCG
GCACCTTTCAG -> CACCTTTCAGA
GTGGGGACAGA -> TGGGGACAGAA
CCTATTTACCC -> CTATTTACCCT
GACAGCACAAC -> ACAGCACAACG
ACTTATGCGGC -> CTTATGCGGCA
ATCAAGCACAG -> TCAAGCACAGG
GGGGGTATGCC -> GGGGTATGCCC
CGTGAGTCACC -> GTGAGTCACCC
CCCTCGGCACT -> CCTCGGCACTC
CATGGGGTCTC -> ATGGGGTCTCC
AGCACCGGCTC -> GCACCGGCTCC
CTAACAGCCGG -> TAACAGCCGGA
GATGCAAGGAG -> ATGCAAGGAGT
ACAGGTAGACT -> CAGGTAGACTC
CTTATTAACTG -> TTATTAACTGC
TACTAAACCTT -> ACTAAACCTTA
CCCGCATCGAA -> CCGCATCGAAG
GGCGGAGTGCG -> GCGGAGTGCGC
CACTTATTTTT -> ACTTATTTTTC
AAGCCCATCGT -> AGCCCATCGTA
TCGCCCGAATA -> CGCCCGAATAA
TAAGGGACCAT -> AAGGGACCATG
TCGGCACGTGC -> CGGCACGTGCC
AGTGCGCCTTT -> GTGCGCCTTTT
CTTTCATCGTT -> TTTCATCGTTG
CAAGAACATGG -> AAGAACATGGG
TGCCCTGAAAT -> GCCCTGAAATG
CTCGGGATAGA -> TCGGGATAGAA
GAACGATAGTC -> AACGATAGTCC
GTTCCTTAGCC -> TTCCTTAGCCC
GAACAAAGAAG -> AACAAAGAAGA
ACCTGTTACAT -> CCTGTTACATT
AGGGAGCGCGC -> GGGAGCGCGCC
AGAATGGGAAC -> GAATGGGAACA
GCAAACGAGAG -> CAAACGAGAGG
ACACTGCGCCT -> CACTGCGCCTG
CCTTACCCTCG -> CTTACCCTCGG
TACGCGGGGGG -> ACGCGGGGGGC
GAGGTCTTTCA -> AGGTCTTTCAG
GCCGATTTAGT -> CCGATTTAGTG
AGCAAACGAGA -> GCAAACGAGAG
CAGTCCTGGCA -> AGTCCTGGCAA
ATAGCTACGCG -> TAGCTACGCGG
ACACGTGACTT -> CACGTGACTTG
TAATCTCAACC -> AATCTCAACCT
AGAACATGGGC -> GAACATGGGCA
ACTGGTTCCTT -> CTGGTTCCTTA
CCGGCGCATTG -> CGGCGCATTGC
TGTGTGGATGC -> GTGTGGATGCT
CTGTGTCCCGG -> TGTGTCCCGGA
ACTGCGCCTGA -> CTGCGCCTGAA
CCAGGTACGAT -> CAGGTACGATG
TGACTTGAGTT -> GACTTGAGTTT
GAACCCGAACA -> AACCCGAACAC
ATGTCGCCCGA -> TGTCGCCCGAA
CTCCTATCGGC -> TCCTATCGGCG
TTTTAAATGCA -> TTTAAATGCAG
CCTCTGTGAAT -> CTCTGTGAATC
GTTACTCTTCG -> TTACTCTTCGA
ACCATGATCTC -> CCATGATCTCA
TCTTTCAGCCC -> CTTTCAGCCCT
TGGGCATCGAC -> GGGCATCGACG
CCTATCGGCGA -> CTATCGGCGAC
TCCGCGACTCG -> CCGCGACTCGA
CGCTCTATGTG -> GCTCTATGTGT
CTCTATGCCGG -> TCTATGCCGGA
TATCGGCGACA -> ATCGGCGACAC
GCTCTATGCCG -> CTCTATGCCGG
GTGTAGGGGTA -> TGTAGGGGTAA
AGTCTGCCGTG -> GTCTGCCGTGC
ATTCACGCGAC -> TTCACGCGACT
TAGCAGTCACA -> AGCAGTCACAT
CGGGATACTGC -> GGGATACTGCC
CCATCGTAATT -> CATCGTAATTG
TCTGTCTAGAC -> CTGTCTAGACG
CTGTTCCCCAG -> TGTTCCCCAGG
GAAGAACTTGC -> AAGAACTTGCT
ACACTCTTTAC -> CACTCTTTACG
TGCGCGGGCAG -> GCGCGGGCAGC
CGGGGGGCAGT -> GGGGGGCAGTC
GGGATAGAACG -> GGATAGAACGA
CCCTGCATGGG -> CCTGCATGGGG
GTGGCTTAGGG -> TGGCTTAGGGA
ATCCATTTTAT -> TCCATTTTATG
CTACCGAACAA -> TACCGAACAAA
AAAGCACCGGC -> AAGCACCGGCT
CAACACTCTTT -> AACACTCTTTA
TGAGCCGAATT -> GAGCCGAATTA
TGACGCCCCAG -> GACGCCCCAGA
AGGAGCAAGGG -> GGAGCAAGGGT
AGTACAGGTAG -> GTACAGGTAGA
ACCCTCGGGAT -> CCCTCGGGATA
TGCGACGGGAG -> GCGACGGGAGC
GAGAGGACTTC -> AGAGGACTTCC
GGGCAGTCCAA -> GGCAGTCCAAT
ATTGCGGTGCC -> TTGCGGTGCCG
CGCCTGAAACA -> GCCTGAAACAT
GGTTAACTTAT -> GTTAACTTATG
ATAATCCAGCG -> TAATCCAGCGG
TCGTGAGTCAC -> CGTGAGTCACC
GAACGCACACG -> AACGCACACGT
TGGCTCCATCA -> GGCTCCATCAC
TGAAACATCTG -> GAAACATCTGA
CTCGACAGCCG -> TCGACAGCCGC
CGACCATGCGC -> GACCATGCGCG
AAGCACAGGCC -> AGCACAGGCCC
AAGGGTTCTTA -> AGGGTTCTTAT
TAAGGCCACCG -> AAGGCCACCGG
CAGAGGCTGCA -> AGAGGCTGCAG
CCGAATAATCA -> CGAATAATCAT
AATATCTAAGC -> ATATCTAAGCG
TTGGTCGCCCG -> TGGTCGCCCGT
TTAGGCTCAGG -> TAGGCTCAGGA
CACTCGAAGAA -> ACTCGAAGAAA
ATGCATTACTG -> TGCATTACTGT
TTTTATGAGAA -> TTTATGAGAAC
AGCATACCAGC -> GCATACCAGCA
ACGATGAAGCT -> CGATGAAGCTT
GATTCCGATGT -> ATTCCGATGTC
GGGCGGAGTGC -> GGCGGAGTGCG
CTGGACTTGGC -> TGGACTTGGCA
TGCATCCAAGC -> GCATCCAAGCG
TTAGTGTAGGG -> TAGTGTAGGGG
GGAGATGCAAG -> GAGATGCAAGG
ACTGTGTTCAT -> CTGTGTTCATT
GCTTAAGTAGT -> CTTAAGTAGTG
ATAGTCCGCCA -> TAGTCCGCCAG
GAGGCTGCAGT -> AGGCTGCAGTA
CGCTCCATCGG -> GCTCCATCGGA
CATGGTGTTGG -> ATGGTGTTGGC
TCTGTTCCCCA -> CTGTTCCCCAG
GTTGGCCACGT -> TTGGCCACGTT
GTTTTAAATGC -> TTTTAAATGCA
CCGGGATACTG -> CGGGATACTGC
CTAAGCGGGCA -> TAAGCGGGCAG
AACACTCTTTA -> ACACTCTTTAC
CTTACCCTCGG -> TTACCCTCGGG
GCTCATGTCGC -> CTCATGTCGCC
CCGCTCCTTCA -> CGCTCCTTCAG
CACCCCGGATG -> ACCCCGGATGT
ACAGCCGCGAA -> CAGCCGCGAAA
TGCGTACACGG -> GCGTACACGGA
GGCACTTCACC -> GCACTTCACCC
TAAGCGGGCAG -> AAGCGGGCAGC
GAAGCCCATCG -> AAGCCCATCGT
GTAAGCCGTTG -> TAAGCCGTTGG
CCGCGAAAAGC -> CGCGAAAAGCA
CCGGACCTGTT -> CGGACCTGTTA
CGACAGCCGCG -> GACAGCCGCGA
TTGTACTACCG -> TGTACTACCGA
CCGGATGTCGG -> CGGATGTCGGC
CCATTTTATGA -> CATTTTATGAG
CCAATGTCTAT -> CAATGTCTATG
CCGTAGAGGAG -> CGTAGAGGAGC
CCCGTCATCCC -> CCGTCATCCCC
GATGTCAAACA -> ATGTCAAACAC
TGTACTACCGA -> GTACTACCGAA
CCTGAAATGTG -> CTGAAATGTGT
GCATCAAACTA -> CATCAAACTAC
GCCCTGGGGGA -> CCCTGGGGGAG
GCATATAACAC -> CATATAACACA
CGATGAAGCTT -> GATGAAGCTTA
CGTAGAGGAGC -> GTAGAGGAGCA
GTGTACTAAAC -> TGTACTAAACC
GTGCGCTGGCT -> TGCGCTGGCTC
CCGAACTCCCG -> CGAACTCCCGT
CTCAGGACAAT -> TCAGGACAATC
GCCACGTTAGT -> CCACGTTAGTG
TGCGGCACTTA -> GCGGCACTTAC
ATGGGGTCTCC -> TGGGGTCTCCC
CACACGTGACT -> ACACGTGACTT
CAATCAAGCAC -> AATCAAGCACA
GCGTCGTGAGT -> CGTCGTGAGTC
GGGTTGCGCTG -> GGTTGCGCTGT
CCGGTATCCGC -> CGGTATCCGCT
GCCACCGGGAT -> CCACCGGGATA
ACACGCTCTAT -> CACGCTCTATG
TTCAGCAAACG -> TCAGCAAACGA
AACACTTTCAT -> ACACTTTCATC
CCAGCGGGTGC -> CAGCGGGTGCA
CGCCAGGGGGT -> GCCAGGGGGTA
ACCGACTGGAC -> CCGACTGGACT
CCTGGCAATGG -> CTGGCAATGGG
TGTCGGACTGA -> GTCGGACTGAG
ACGTGACTTGA -> CGTGACTTGAG
ATCATTCCGGT -> TCATTCCGGTT
CTGTTACATTT -> TGTTACATTTT
CTAACCGACTG -> TAACCGACTGG
AACTACCGGCA -> ACTACCGGCAC
TTAGCTCCGCG -> TAGCTCCGCGA
GCTTGATTCCG -> CTTGATTCCGA
CATTTTGGAAT -> ATTTTGGAATG
CCGTGGCTTAG -> CGTGGCTTAGG
AATGGGCGGAG -> ATGGGCGGAGT
ATCCAAGCGGT -> TCCAAGCGGTC
GTCAACACTCT -> TCAACACTCTT
AGACTCAACGT -> GACTCAACGTT
TAGTCCGCCAG -> AGTCCGCCAGG
TCCCTGCATGG -> CCCTGCATGGG
CGATTCCGAGT -> GATTCCGAGTC
TAGAGATGGTT -> AGAGATGGTTA
CCATTATGAGA -> CATTATGAGAT
TCGTACGCTTC -> CGTACGCTTCG
ACGCTAACAGC -> CGCTAACAGCC
GCCCGTGGCTT -> CCCGTGGCTTA
GGTTAGGCTCA -> GTTAGGCTCAG
CCTCTAGACGC -> CTCTAGACGCA
TCACCCCTCTA -> CACCCCTCTAG
TGGCAATGGGC -> GGCAATGGGCG
GGGTCTCCCCT -> GGTCTCCCCTG
AGCCGGACCAC -> GCCGGACCACA
TAGCTCCGCGA -> AGCTCCGCGAC
GGCCACGTTAG -> GCCACGTTAGT
ATGAGCCGAAT -> TGAGCCGAATT
CCTGAAACATC -> CTGAAACATCT
TCCTAACCGAC -> CCTAACCGACT
CATCAAACTAC -> ATCAAACTACG
CTAATTTACAA -> TAATTTACAAG
CCTCGGGATAG -> CTCGGGATAGA
TTTCAGCCCTT -> TTCAGCCCTTA
AGCATATAACA -> GCATATAACAC
GACCTCGAGGC -> ACCTCGAGGCA
ACACAAGCCTC -> CACAAGCCTCC
TTTTCCGCCCG -> TTTCCGCCCGC
AGCACAACGGT -> GCACAACGGTT
GCGAGGTCTTT -> CGAGGTCTTTC
AAGATAAGGCC -> AGATAAGGCCA
ATCGGACCTCG -> TCGGACCTCGC
TTCAGCCCTTA -> TCAGCCCTTAC
AATTCTGCGTA -> ATTCTGCGTAC
AACATCTGACA -> ACATCTGACAG
CGGACTGAGGC -> GGACTGAGGCT
GTCTAGACGCT -> TCTAGACGCTA
ATACTGCCTTG -> TACTGCCTTGC
ACCAGAAGAAT -> CCAGAAGAATC
GGCCACCGGGA -> GCCACCGGGAT
AACACTAACTA -> ACACTAACTAC
GTCGGCACGTG -> TCGGCACGTGC
TAGACTCACTC -> AGACTCACTCA
GGCTGCAGTAA -> GCTGCAGTAAA
CACTTATCCAT -> ACTTATCCATT
TAACCGACTGG -> AACCGACTGGA
GAAGCTTAAGT -> AAGCTTAAGTA
CCTCGGCACTC -> CTCGGCACTCC
GTCGCCCGAAT -> TCGCCCGAATA
GTTATATAGAG -> TTATATAGAGA
ACGCTTCGATC -> CGCTTCGATCC
AGGTTACTCTT -> GGTTACTCTTC
GGAATTATAAT -> GAATTATAATC
ATCACTGTGTT -> TCACTGTGTTC
GCCGCATCAAA -> CCGCATCAAAC
TCGACAGCCGC -> CGACAGCCGCG
TGTATGAAGTC -> GTATGAAGTCG
CAGACTCAACG -> AGACTCAACGT
GTAGTGCGCCT -> TAGTGCGCCTT
CATTGCGACGG -> ATTGCGACGGG
ACTCGACAGCC -> CTCGACAGCCG
CCTTTCAGATG -> CTTTCAGATGG
GCCTTTTGTCC -> CCTTTTGTCCA
TCGATCTGTCT -> CGATCTGTCTA
AGACATTCGCC -> GACATTCGCCA
AACTTGCTCCC -> ACTTGCTCCCC
CTTAGGGAGCG -> TTAGGGAGCGC
GTGTTTTAAAT -> TGTTTTAAATG
CGGGTGCAGCA -> GGGTGCAGCAT
GCGCGCCCGGA -> CGCGCCCGGAC
CCGCCCGCATC -> CGCCCGCATCG
TGCCCTAAATG -> GCCCTAAATGC
ATGGAGAACAG -> TGGAGAACAGT
CTGTCACGCGA -> TGTCACGCGAC
GCGCATTGCGA -> CGCATTGCGAC
CATCTGACAGC -> ATCTGACAGCA
TGGGGGAGTTC -> GGGGGAGTTCT
ATAGGTTAGGG -> TAGGTTAGGGT
GCGCCTTTTGT -> CGCCTTTTGTC
TTCGTAAGCTC -> TCGTAAGCTCT
CGATCCCATTA -> GATCCCATTAT
CCGGACCACAG -> CGGACCACAGA
ATAGAGATGGT -> TAGAGATGGTT
AATCGCACAGC -> ATCGCACAGCA
ATGAAACCACC -> TGAAACCACCG
TGTCGCTAATC -> GTCGCTAATCA
GCGGGTGCAGC -> CGGGTGCAGCA
GCGGTCTGACC -> CGGTCTGACCA
TATAGCCAGGT -> ATAGCCAGGTA
TACCGAACAAA -> ACCGAACAAAG
ACGTGCCGATC -> CGTGCCGATCA
TATAGGGGCTT -> ATAGGGGCTTG
ATAATCCATAT -> TAATCCATATG
TCTTTACGGCG -> CTTTACGGCGG
CTCACTCAATC -> TCACTCAATCG
GTCAAACACTA -> TCAAACACTAA
TTATAGGGGCT -> TATAGGGGCTT
ACACTTTCATC -> CACTTTCATCG
CATTGAACCCG -> ATTGAACCCGA
TTCCGGTTATA -> TCCGGTTATAG
CAGAAGAATCG -> AGAAGAATCGC
GAATGGGAACA -> AATGGGAACAC
AACCCGAACAC -> ACCCGAACACT
GGGCCCCACTG -> GGCCCCACTGG
GATGAAGCTTA -> ATGAAGCTTAA
GTAAGCTCTAT -> TAAGCTCTATG
TCGGACCTCGC -> CGGACCTCGCA
TGTTATATAGA -> GTTATATAGAG
GGTATGCCCTG -> GTATGCCCTGA
CAACCTGTTGT -> AACCTGTTGTA
CTACGCTAGTG -> TACGCTAGTGC
TACGCTAGTGC -> ACGCTAGTGCG
CCGTCATCCCC -> CGTCATCCCCT
TTGTCGGACTG -> TGTCGGACTGA
CGTAAGCTCTA -> GTAAGCTCTAT
GGACAGAAGCC -> GACAGAAGCCC
CTTATCCATTT -> TTATCCATTTT
GGACTTGGCAC -> GACTTGGCACC
TAACTACCGGC -> AACTACCGGCA
AATGAAACCAC -> ATGAAACCACC
CGCCGCGTCTA -> GCCGCGTCTAG
CTGCGCCTGAA -> TGCGCCTGAAA
ACCCCGGATGT -> CCCCGGATGTC
AACAGCCGGAC -> ACAGCCGGACC
GCGACTGGGCC -> CGACTGGGCCC
CCCGAATAATC -> CCGAATAATCA
GCGCTGTCGCT -> CGCTGTCGCTA
GTTGAAAGTCC -> TTGAAAGTCCG
CGTTGACCGTC -> GTTGACCGTCA
CCGATTTAGTG -> CGATTTAGTGT
GATCCAACTAG -> ATCCAACTAGG
GACATTCGCCA -> ACATTCGCCAG
ACGCCCCAGAC -> CGCCCCAGACT
CGAATAATCAT -> GAATAATCATT
CGAAGAAAAAT -> GAAGAAAAATA
TCGGACTGAGG -> CGGACTGAGGC
CTCAACGTTAG -> TCAACGTTAGC
TAGGATGAGCC -> AGGATGAGCCG
GCTGCAGTAAA -> CTGCAGTAAAA
CCGTAGCTGCC -> CGTAGCTGCCC
ATATAGAGATG -> TATAGAGATGG
CGCGTCTAGCC -> GCGTCTAGCCT
AAAGTCCGTTG -> AAGTCCGTTGT
TATGTGTTTTA -> ATGTGTTTTAA
TTCACGCGACT -> TCACGCGACTG
GCCGGAGATGC -> CCGGAGATGCA
TAATCCATATG -> AATCCATATGT
TCTAGACGCAG -> CTAGACGCAGA
TGGCCTCTGTG -> GGCCTCTGTGA
AAGGAGGCGTC -> AGGAGGCGTCG
TGAAAGTCCGT -> GAAAGTCCGTT
CAATGTCTATG -> AATGTCTATGC
ACCGGGATACT -> CCGGGATACTG
CTCACTCGTTG -> TCACTCGTTGA
GATGGCTTATA -> ATGGCTTATAA
ACGGAGTACAG -> CGGAGTACAGG
TTTCTGTTCCC -> TTCTGTTCCCC
GTATCCGCTCC -> TATCCGCTCCA
AGGGTTCTTAT -> GGGTTCTTATT
GACTTGAGTTT -> ACTTGAGTTTA
TATAGAGATGG -> ATAGAGATGGT
TTAGCAGTCAC -> TAGCAGTCACA
CCGGAGATGCA -> CGGAGATGCAA
TCGCACAGCAA -> CGCACAGCAAG
GGGGCTTGAAC -> GGGCTTGAACG
ATAGCCAGGTA -> TAGCCAGGTAC
TATATAGAGAT -> ATATAGAGATG
GGACAATCAAG -> GACAATCAAGC
GCATTACTGTC -> CATTACTGTCA
CTCCCCTGTGT -> TCCCCTGTGTC
CCGCGTCTAGC -> CGCGTCTAGCC
AGGATGAGCCG -> GGATGAGCCGA
TTTTGGAATGT -> TTTGGAATGTA
GAGTTTAGCTC -> AGTTTAGCTCC
TTAGGGAGCGC -> TAGGGAGCGCG
TATAGCTACGC -> ATAGCTACGCG
TTGATTCCGAT -> TGATTCCGATG
CATCGTTGAAA -> ATCGTTGAAAG
AACAGTCCGGT -> ACAGTCCGGTA
CCCTGGGGGAG -> CCTGGGGGAGT
ATCTCAACCTG -> TCTCAACCTGT
GACCTATTTAC -> ACCTATTTACC
AGATAAGGCCA -> GATAAGGCCAC
ACATGGTGTTG -> CATGGTGTTGG
CCAGGGGGTAT -> CAGGGGGTATG
TGCGCCTTTTG -> GCGCCTTTTGT
AGAGATCCTAA -> GAGATCCTAAC
TAGACGCAGAC -> AGACGCAGACT
GGACCATGATC -> GACCATGATCT
CGCGGGCAGCG -> GCGGGCAGCGA
ACGTTAGCAGT -> CGTTAGCAGTC
TAAGTAGTGCG -> AAGTAGTGCGC
AAGAATGAAAC -> AGAATGAAACC
TGTCCCGGAAT -> GTCCCGGAATT
GGAGTGATCCA -> GAGTGATCCAA
GTTAGGGTACA -> TTAGGGTACAC
AAGGCCACCGG -> AGGCCACCGGG
AGCTTGATTCC -> GCTTGATTCCG
CCCGTGGCTTA -> CCGTGGCTTAG
AATGGGAACAC -> ATGGGAACACT
TATGCCCTGAA -> ATGCCCTGAAA
CGATTTAGTGT -> GATTTAGTGTA
GAGATGGTTAA -> AGATGGTTAAC
GCAGTCTGCCG -> CAGTCTGCCGT
GTCACCCCTCT -> TCACCCCTCTA
CCACTGGGAGG -> CACTGGGAGGG
CGTCATCCCCT -> GTCATCCCCTA
CGCGACCATGC -> GCGACCATGCG
AGCAAGGGTTC -> GCAAGGGTTCT
GGCACTCCTCA -> GCACTCCTCAC
GTTGGCCTCTG -> TTGGCCTCTGT
GTTGTACTGGT -> TTGTACTGGTT
GAGTGCGCTGG -> AGTGCGCTGGC
GTCGTATGGAT -> TCGTATGGATT
GTTCGACCTAT -> TTCGACCTATT
CGCGACTGGGC -> GCGACTGGGCC
TCGTTGACCGT -> CGTTGACCGTC
GGCCTCTGTGA -> GCCTCTGTGAA
CAACTAGGATG -> AACTAGGATGA
GTACTAAACCT -> TACTAAACCTT
TTCTGTTCCCC -> TCTGTTCCCCA
CTCTTCGATAG -> TCTTCGATAGC
CAAACGAGAGG -> AAACGAGAGGA
GCCCTCGGCAC -> CCCTCGGCACT
CGAACAAAGAA -> GAACAAAGAAG
TCCAATGCGCC -> CCAATGCGCCG
GATAATCCAGC -> ATAATCCAGCG
GGGGTAAATTA -> GGGTAAATTAT
GTCCAATGTCT -> TCCAATGTCTA
CTTTCGTAAGC -> TTTCGTAAGCT
TCTCACTCGTT -> CTCACTCGTTG
TGAGTTTAATA -> GAGTTTAATAT
ACTCCGGCGCA -> CTCCGGCGCAT
TATCCGCTCCA -> ATCCGCTCCAT
TGTAGGGGTAA -> GTAGGGGTAAA
TATTTCTGTTC -> ATTTCTGTTCC
GTGATCCAAGG -> TGATCCAAGGA
CTGAGGCTACG -> TGAGGCTACGC
AGATGCAAGGA -> GATGCAAGGAG
ACCTCGAGGCA -> CCTCGAGGCAG
TTCGATCCCAT -> TCGATCCCATT
GCCCCAGACTC -> CCCCAGACTCA
GCACAGCAAGG -> CACAGCAAGGA
ACTCGTTGACC -> CTCGTTGACCG
TCGAAGAAAAA -> CGAAGAAAAAT
TGACCAGAAGA -> GACCAGAAGAA
GATTCCGAGTC -> ATTCCGAGTCT
TCGCAGTCTGC -> CGCAGTCTGCC
CGGTTAGGCTC -> GGTTAGGCTCA
ATGTCGGCACG -> TGTCGGCACGT
AGGGGGTATGC -> GGGGGTATGCC
TGTCAAACACT -> GTCAAACACTA
AGATGGAGAAC -> GATGGAGAACA
GCTCTATGTGT -> CTCTATGTGTT
GGCACGTGCCG -> GCACGTGCCGA
ACTTCACCCCG -> CTTCACCCCGG
TGTACTGGTTC -> GTACTGGTTCC
CTGTGGGGACA -> TGTGGGGACAG
TCCGCCCGCAT -> CCGCCCGCATC
GCCCGAATAAT -> CCCGAATAATC
ATGTCTATGCC -> TGTCTATGCCC
CTCGCAGCCTC -> TCGCAGCCTCC
TAGAACGATAG -> AGAACGATAGT
CAGCAAGGACC -> AGCAAGGACCG
GTACTACCGAA -> TACTACCGAAC
AACCGACTGGA -> ACCGACTGGAC
TTTTGTCCAAT -> TTTGTCCAATG
TCTTATTAACT -> CTTATTAACTG
CAGCGAAAGAT -> AGCGAAAGATA