30 100
AAATACGTCGCCCGACGTTCGACTATAGCT|GCCCGACGTTCCGTGTCGAGAGTCCCACAC
TCCCCCTTGTAATATCGAGATCGTCGCGTA|ACGTCGCCCGACGTTCATGAAACTGTCCAG
ACCTGCAAGAAACTAAATACGTCGCCCGAC|GAGCCCGCTTCGCAAGTAAGCGTGTGTCAC
ACGTCGCCCGACGTTCCGTGTCGAGAGTCC|TTCTCTTGCCAGCAGGCCTATGTATACTTA
GAGCCCGCTTCGCAAGTAAGCGTGTGTCAC|TGACTTCAGGACCTCTTAGATGACTGCCAC
CAAGAAACTAAATACGTCGCCCGACGTTCT|GCAAGAAACTAAATACGTCGCCCGACGTTC
ACGTCGCCCGACGTTCCCAACAAGTTATAA|TATTCTGATCAGCAAGAAACTAAATACGTC
ACGACCGGGGTATCCGTGGTGAGCAAGAAA|CTACCAACAGCAAGAAACTAAATACGTCGC
TGCGCAAGAAACTAAATACGTCGCCCGACG|TCGGCGGTTAAGCGTCTTAGGCTGCCGCGG
CGCGTATAAGGAACCAGCAAGAAACTAAAT|GTCCAGGGAGATAGTGAGCTACCTCTTGAA
AAACTAAATACGTCGCCCGACGTTCAGCGC|ACCGGGGTATCCGTGGTGAGCAAGAAACTA
CCTATGTATACTTAGTTCCAAGTCAAAAAC|GAGGTCATATGAACTTCGTGCGGCACCGCG
CCCGACGTTCCCAACAAGTTATAATTCGAT|GATCAGCAAGAAACTAAATACGTCGCCCGA
TTTGGCATCGGTGCTCCAGACCTGCAAGAA|CAGCAGAACCTTGTTGCCTGAGCCCGCTTC
GGTGTACGACCGGGGTATCCGTGGTGAGCA|CTGGCCTACCAACAGCAAGAAACTAAATAC
GACGTTCCCAACAAGTTATAATTCGATTAG|CAGCAAGAAACTAAATACGTCGCCCGACGT
TCAGTAGTCCGCCATTCGCAATCGTTACTT|AACTAAATACGTCGCCCGACGTTCTGACGG
AATACGTCGCCCGACGTTCTATACCGTGAC|CAAATACTAGACCGAAATAAGCGATCTTCC
ATCGTCGCGTATAAGGAACCAGCAAGAAAC|AAACTGTCCAGGGAGATAGTGAGCTACCTC
TCTCTTGCCAGCAGGCCTATGTATACTTAG|ATCGCCTGAGTACATGAGGTCATATGAACT
TCGGTGCTCCAGACCTGCAAGAAACTAAAT|ACCTTGTTGCCTGAGCCCGCTTCGCAAGTA
CAATCGTTACTTTTTACCTTTCACTGGGTA|ACGTTCTGACGGCAAGAAACTAAATACGTC
AATACGTCGCCCGACGTTCCCAACAAGTTA|GAATATTCTGATCAGCAAGAAACTAAATAC
CGCCCGACGTTCAGCGCAAGAAACTAAATA|TGGTGAGCAAGAAACTAAATACGTCGCCCG
ATATAGGCGTTTGGCATCGGTGCTCCAGAC|CAAGGAGGCCAGCAGAACCTTGTTGCCTGA
CGTTCGAGCTTAAATAAGTTACTTATTGCC|AGTAAATTGGCTGAGGGGCAATGCTAGTTG
TGGCAAGAAACTAAATACGTCGCCCGACGT|GTCGCCCGACGTTCAAATACTAGACCGAAA
ATCGAGATCGTCGCGTATAAGGAACCAGCA|TTCATGAAACTGTCCAGGGAGATAGTGAGC
CGCCCGACGTTCGACTATAGCTTTGGTTAA|TTCCGTGTCGAGAGTCCCACACTATTAATG
CGTTCCACCTTGTTCACGAGATGCAAGCTA|AAATACGTCGCCCGACGTTCTATACCGTGA
GACGTCACCGTTCGTTGACGAACAATCGCC|ACCTGTTATCAGTAGTCCGCCATTCGCAAT
TGAGCCCGCTTCGCAAGTAAGCGTGTGTCA|GTGACTTCAGGACCTCTTAGATGACTGCCA
GTTCTGACGGCAAGAAACTAAATACGTCGC|CGTTCCCCCTTGTAATATCGAGATCGTCGC
GCCTATGTATACTTAGTTCCAAGTCAAAAA|TGAGGTCATATGAACTTCGTGCGGCACCGC
CGACGTTCGGGATTGCAAGAAACTAAATAC|TATAAGGAACCAGCAAGAAACTAAATACGT
ACGTCGCCCGACGTTCGACTATAGCTTTGG|GACGTTCCGTGTCGAGAGTCCCACACTATT
GCCCGACGTTCAGCGCAAGAAACTAAATAC|GGTGAGCAAGAAACTAAATACGTCGCCCGA
CGACGTTCCCAACAAGTTATAATTCGATTA|TCAGCAAGAAACTAAATACGTCGCCCGACG
GCGTATAAGGAACCAGCAAGAAACTAAATA|TCCAGGGAGATAGTGAGCTACCTCTTGAAT
GACGGCAAGAAACTAAATACGTCGCCCGAC|CCCCTTGTAATATCGAGATCGTCGCGTATA
GGTAGTTGATAACGCCCGTTGATGCCGGCC|CGTCGCCCGACGTTCGGGATTGCAAGAAAC
GCAGAACCTTGTTGCCTGAGCCCGCTTCGC|AAGACCGGTACACACCGTGACTTCAGGACC
AATCCACGCCGCAAGAAACTAAATACGTCG|AGTTACTTATTGCCGCACTCTCTCAAAATC
TTCAAGGAGGCCAGCAGAACCTTGTTGCCT|CTGTTACGTTTTAAAGACCGGTACACACCG
TACGTCGCCCGACGTTCGGGATTGCAAGAA|ATCGTCGCGTATAAGGAACCAGCAAGAAAC
GCGAGGGTTAGCAAGAAACTAAATACGTCG|CCCGTTGATGCCGGCCTGGTCGGTGGCAAG
GAAACTAAATACGTCGCCCGACGTTCTATA|CGACGTTCAAATACTAGACCGAAATAAGCG
TAAATACGTCGCCCGACGTTCTATACCGTG|TTCAAATACTAGACCGAAATAAGCGATCTT
TTGTTCACGAGATGCAAGCTACCTGTTATC|GCCCGACGTTCTATACCGTGACGCAAGAAA
AGAAACTAAATACGTCGCCCGACGTTCTGA|AAGAAACTAAATACGTCGCCCGACGTTCCC
AGTTACTTATTGCCGCACTCTCTCAAAATC|GGCAATGCTAGTTGTTGCCAATCACTATTA
GAAACTGTCCAGGGAGATAGTGAGCTACCT|CCGATATAGGCGTTTGGCATCGGTGCTCCA
AAACTAAATACGTCGCCCGACGTTCATGAA|CACTCTCTCAAAATCGTGGTATAAGCTCCG
TTGCGCAAGAAACTAAATACGTCGCCCGAC|ATCGGCGGTTAAGCGTCTTAGGCTGCCGCG
CAAGAAACTAAATACGTCGCCCGACGTTCT|GCCCGACGTTCAAATACTAGACCGAAATAA
TCCCGCAAGAAACTAAATACGTCGCCCGAC|GGGATTAAAATCCACGCCGCAAGAAACTAA
CCGACGTTCGAGCTTAAATAAGTTACTTAT|TGCCAGTAAATTGGCTGAGGGGCAATGCTA
AGCAAGAAACTAAATACGTCGCCCGACGTT|GAGCTACCTCTTGAATATTCTGATCAGCAA
AACCTTGTTGCCTGAGCCCGCTTCGCAAGT|CCGGTACACACCGTGACTTCAGGACCTCTT
GTTCACCTGCCAGTAAATTGGCTGAGGGGC|AAGTTAGACATCTCATCACCTATCGCAGCC
GAAATAAGCGATCTTCCCGCAAGAAACTAA|TTCGATTAGGGAGAGGGATTAAAATCCACG
CGCCCGACGTTCCCCCTTGTAATATCGAGA|GAAACTAAATACGTCGCCCGACGTTCATGA
ATACTAGACCGAAATAAGCGATCTTCCCGC|CAAGTTATAATTCGATTAGGGAGAGGGATT
ATCCACGCCGCAAGAAACTAAATACGTCGC|GTTACTTATTGCCGCACTCTCTCAAAATCG
GGTCGGTGGCAAGAAACTAAATACGTCGCC|AAATACGTCGCCCGACGTTCAAATACTAGA
TAAATACGTCGCCCGACGTTCAGCGCAAGA|GGGTATCCGTGGTGAGCAAGAAACTAAATA
GGCAAGAAACTAAATACGTCGCCCGACGTT|TGTACGACCGGGGTATCCGTGGTGAGCAAG
CAAGAAACTAAATACGTCGCCCGACGTTCC|TAAAATCCACGCCGCAAGAAACTAAATACG
TAAATACGTCGCCCGACGTTCACCTGCCAG|AAGTAAGCGTGTGTCACAAGTTAGACATCT
CCCCCTTGTAATATCGAGATCGTCGCGTAT|CGTCGCCCGACGTTCATGAAACTGTCCAGG
TAGGTGTACGACCGGGGTATCCGTGGTGAG|ACCTGGCCTACCAACAGCAAGAAACTAAAT
GAAACTAAATACGTCGCCCGACGTTCCGTG|TCGCCCGACGTTCTCTTGCCAGCAGGCCTA
GATTAGGGAGAGGGATTAAAATCCACGCCG|CGACGTTCGAGCTTAAATAAGTTACTTATT
AGCTTTGGTTAAAGTGACATTTCGAAAAGG|ACACTATTAATGATATTACTTGCGCAAGAA
GTCGCCCGACGTTCTATACCGTGACGCAAG|ACTAGACCGAAATAAGCGATCTTCCCGCAA
AAAATCGTGGTATAAGCTCCGATATAGGCG|CTATTACATGGTCTCATTATTCAAGGAGGC
AAACTAAATACGTCGCCCGACGTTCCCAAC|CCTCTTGAATATTCTGATCAGCAAGAAACT
AAGCTACCTGTTATCAGTAGTCCGCCATTC|CCGTGACGCAAGAAACTAAATACGTCGCCC
GTACGACCGGGGTATCCGTGGTGAGCAAGA|GCCTACCAACAGCAAGAAACTAAATACGTC
AGTTCCAAGTCAAAAACATGCATCGGCGGT|CTTCGTGCGGCACCGCGAGGGTTAGCAAGA
GAGAGGGATTAAAATCCACGCCGCAAGAAA|CGAGCTTAAATAAGTTACTTATTGCCGCAC
TATACCGTGACGCAAGAAACTAAATACGTC|AGCGATCTTCCCGCAAGAAACTAAATACGT
GCTGCCGCGGGCTCTCATCACTACCTAGTG|CGCCCGACGTTCCACCTTGTTCACGAGATG
ATCCGTGGTGAGCAAGAAACTAAATACGTC|AAGAAACTAAATACGTCGCCCGACGTTCTC
ATTCCCGAATAGGTGTACGACCGGGGTATC|ACGTTCACGACCTGGCCTACCAACAGCAAG
TCGCCCGACGTTCATGAAACTGTCCAGGGA|ATCGTGGTATAAGCTCCGATATAGGCGTTT
AAGAAACTAAATACGTCGCCCGACGTTCGA|AATACGTCGCCCGACGTTCCGTGTCGAGAG
GACCTGCAAGAAACTAAATACGTCGCCCGA|TGAGCCCGCTTCGCAAGTAAGCGTGTGTCA
CCGACGTTCTCTTGCCAGCAGGCCTATGTA|ACGAACAATCGCCTGAGTACATGAGGTCAT
TACCTGTTATCAGTAGTCCGCCATTCGCAA|GACGCAAGAAACTAAATACGTCGCCCGACG
AGGGGCAATGCTAGTTGTTGCCAATCACTA|GCAGCCTCGGTTCCACATCTTTCCGAAGGC
ATCGTGGTATAAGCTCCGATATAGGCGTTT|TTACATGGTCTCATTATTCAAGGAGGCCAG
ACAAGGTGTATCAATTCCCGAATAGGTGTA|AATACGTCGCCCGACGTTCACGACCTGGCC
GTTCGGGATTGCAAGAAACTAAATACGTCG|AGGAACCAGCAAGAAACTAAATACGTCGCC
CCTGCCAGTAAATTGGCTGAGGGGCAATGC|AGACATCTCATCACCTATCGCAGCCTCGGT
TGTTGCCAATCACTATTACATGGTCTCATT|CATCTTTCCGAAGGCCCGGGCTGACAGAAT
TGAGCAAGAAACTAAATACGTCGCCCGACG|AAATACGTCGCCCGACGTTCTCTTGCCAGC
TACGTCGCCCGACGTTCCACCTTGTTCACG|TGGCAAGAAACTAAATACGTCGCCCGACGT
GGTGCTCCAGACCTGCAAGAAACTAAATAC|CTTGTTGCCTGAGCCCGCTTCGCAAGTAAG
CCCTTGTAATATCGAGATCGTCGCGTATAA|TCGCCCGACGTTCATGAAACTGTCCAGGGA
CGCAATCGTTACTTTTTACCTTTCACTGGG|CGACGTTCTGACGGCAAGAAACTAAATACG
TAATGATATTACTTGCGCAAGAAACTAAAT|TCAAAAACATGCATCGGCGGTTAAGCGTCT
TCGCCCGACGTTCTATACCGTGACGCAAGA|CTAGACCGAAATAAGCGATCTTCCCGCAAG
TCACCTGCCAGTAAATTGGCTGAGGGGCAA|GTTAGACATCTCATCACCTATCGCAGCCTC
AAACTAAATACGTCGCCCGACGTTCCACCT|CTGGTCGGTGGCAAGAAACTAAATACGTCG
GTTGCCTGAGCCCGCTTCGCAAGTAAGCGT|CACACCGTGACTTCAGGACCTCTTAGATGA
GTCGCCCGACGTTCATGAAACTGTCCAGGG|AATCGTGGTATAAGCTCCGATATAGGCGTT
TTTCGAAAAGGACCCACAAGGTGTATCAAT|TTGCGCAAGAAACTAAATACGTCGCCCGAC
CGACGTTCCCCCTTGTAATATCGAGATCGT|CTAAATACGTCGCCCGACGTTCATGAAACT
CGTTTGGCATCGGTGCTCCAGACCTGCAAG|GCCAGCAGAACCTTGTTGCCTGAGCCCGCT
CGTTACTTTTTACCTTTCACTGGGTAGTTG|TCTGACGGCAAGAAACTAAATACGTCGCCC
TCCGCCATTCGCAATCGTTACTTTTTACCT|TACGTCGCCCGACGTTCTGACGGCAAGAAA
GAACAATCGCCTGAGTACATGAGGTCATAT|CCATTCGCAATCGTTACTTTTTACCTTTCA
CGTTCTGACGGCAAGAAACTAAATACGTCG|ACGTTCCCCCTTGTAATATCGAGATCGTCG
AACTAAATACGTCGCCCGACGTTCACGACC|AAGCGTCTTAGGCTGCCGCGGGCTCTCATC
CACGAGATGCAAGCTACCTGTTATCAGTAG|ACGTTCTATACCGTGACGCAAGAAACTAAA
TGATAACGCCCGTTGATGCCGGCCTGGTCG|CCGACGTTCGGGATTGCAAGAAACTAAATA
AAAAACATGCATCGGCGGTTAAGCGTCTTA|ACCGCGAGGGTTAGCAAGAAACTAAATACG
TATACTTAGTTCCAAGTCAAAAACATGCAT|ATATGAACTTCGTGCGGCACCGCGAGGGTT
TAAGCGTCTTAGGCTGCCGCGGGCTCTCAT|AACTAAATACGTCGCCCGACGTTCCACCTT
CTTAAATAAGTTACTTATTGCCGCACTCTC|GGCTGAGGGGCAATGCTAGTTGTTGCCAAT
TTCGACTATAGCTTTGGTTAAAGTGACATT|GAGAGTCCCACACTATTAATGATATTACTT
CGGGCTCTCATCACTACCTAGTGACTATTG|CGTTCCACCTTGTTCACGAGATGCAAGCTA
GCAAGCTACCTGTTATCAGTAGTCCGCCAT|TACCGTGACGCAAGAAACTAAATACGTCGC
ATACTTAGTTCCAAGTCAAAAACATGCATC|TATGAACTTCGTGCGGCACCGCGAGGGTTA
ACCTCTTGAATATTCTGATCAGCAAGAAAC|TCCAGACCTGCAAGAAACTAAATACGTCGC
TCGCCCGACGTTCCACCTTGTTCACGAGAT|AAGAAACTAAATACGTCGCCCGACGTTCTA
GCAGGCCTATGTATACTTAGTTCCAAGTCA|TACATGAGGTCATATGAACTTCGTGCGGCA
CGTTGATGCCGGCCTGGTCGGTGGCAAGAA|GGATTGCAAGAAACTAAATACGTCGCCCGA
CAATCACTATTACATGGTCTCATTATTCAA|TCCGAAGGCCCGGGCTGACAGAATCCTGTT
GGGTAGTTGATAACGCCCGTTGATGCCGGC|ACGTCGCCCGACGTTCGGGATTGCAAGAAA
CGGCAAGAAACTAAATACGTCGCCCGACGT|CCTTGTAATATCGAGATCGTCGCGTATAAG
GTGTATCAATTCCCGAATAGGTGTACGACC|GTCGCCCGACGTTCACGACCTGGCCTACCA
GACGAACAATCGCCTGAGTACATGAGGTCA|CCGCCATTCGCAATCGTTACTTTTTACCTT
AAGAAACTAAATACGTCGCCCGACGTTCCA|GGCCTGGTCGGTGGCAAGAAACTAAATACG
CATCGGTGCTCCAGACCTGCAAGAAACTAA|GAACCTTGTTGCCTGAGCCCGCTTCGCAAG
TAAGGAACCAGCAAGAAACTAAATACGTCG|GGAGATAGTGAGCTACCTCTTGAATATTCT
CGAAAAGGACCCACAAGGTGTATCAATTCC|CGCAAGAAACTAAATACGTCGCCCGACGTT
TTCCCGCAAGAAACTAAATACGTCGCCCGA|AGGGATTAAAATCCACGCCGCAAGAAACTA
CCGACGTTCTATACCGTGACGCAAGAAACT|ACCGAAATAAGCGATCTTCCCGCAAGAAAC
GAACTTCGTGCGGCACCGCGAGGGTTAGCA|CTGGGTAGTTGATAACGCCCGTTGATGCCG
AAATACGTCGCCCGACGTTCCGTGTCGAGA|GACGTTCTCTTGCCAGCAGGCCTATGTATA
TGAACTTCGTGCGGCACCGCGAGGGTTAGC|ACTGGGTAGTTGATAACGCCCGTTGATGCC
CGCCCGTTGATGCCGGCCTGGTCGGTGGCA|TTCGGGATTGCAAGAAACTAAATACGTCGC
CAGGCAAGAAACTAAATACGTCGCCCGACG|GGTGTACGACCGGGGTATCCGTGGTGAGCA
ACCGTTCGTTGACGAACAATCGCCTGAGTA|TATCAGTAGTCCGCCATTCGCAATCGTTAC
TTTACCTTTCACTGGGTAGTTGATAACGCC|CAAGAAACTAAATACGTCGCCCGACGTTCG
CCGTGACGCAAGAAACTAAATACGTCGCCC|ATCTTCCCGCAAGAAACTAAATACGTCGCC
AATCGCCTGAGTACATGAGGTCATATGAAC|TCGCAATCGTTACTTTTTACCTTTCACTGG
CCACCTTGTTCACGAGATGCAAGCTACCTG|ACGTCGCCCGACGTTCTATACCGTGACGCA
TCGCCCGACGTTCGAGCTTAAATAAGTTAC|CACCTGCCAGTAAATTGGCTGAGGGGCAAT
TTGAATATTCTGATCAGCAAGAAACTAAAT|ACCTGCAAGAAACTAAATACGTCGCCCGAC
ACTGTCCAGGGAGATAGTGAGCTACCTCTT|ATATAGGCGTTTGGCATCGGTGCTCCAGAC
TCATTATTCAAGGAGGCCAGCAGAACCTTG|AGAATCCTGTTACGTTTTAAAGACCGGTAC
GACTATTGACGTCACCGTTCGTTGACGAAC|GCAAGCTACCTGTTATCAGTAGTCCGCCAT
ACTAAATACGTCGCCCGACGTTCCCAACAA|TCTTGAATATTCTGATCAGCAAGAAACTAA
TAAGCGATCTTCCCGCAAGAAACTAAATAC|ATTAGGGAGAGGGATTAAAATCCACGCCGC
CGTTCTATACCGTGACGCAAGAAACTAAAT|AAATAAGCGATCTTCCCGCAAGAAACTAAA
TAAAATCCACGCCGCAAGAAACTAAATACG|ATAAGTTACTTATTGCCGCACTCTCTCAAA
CCTGCAAGAAACTAAATACGTCGCCCGACG|AGCCCGCTTCGCAAGTAAGCGTGTGTCACA
CTGCCAGTAAATTGGCTGAGGGGCAATGCT|GACATCTCATCACCTATCGCAGCCTCGGTT
GAAACTAAATACGTCGCCCGACGTTCCCAA|ACCTCTTGAATATTCTGATCAGCAAGAAAC
CCGACGTTCCACCTTGTTCACGAGATGCAA|AACTAAATACGTCGCCCGACGTTCTATACC
TAAATACGTCGCCCGACGTTCCGTGTCGAG|CGACGTTCTCTTGCCAGCAGGCCTATGTAT
CCGTTGATGCCGGCCTGGTCGGTGGCAAGA|GGGATTGCAAGAAACTAAATACGTCGCCCG
ACCTGCCAGTAAATTGGCTGAGGGGCAATG|TAGACATCTCATCACCTATCGCAGCCTCGG
AATACGTCGCCCGACGTTCACGACCTGGCC|TCTTAGGCTGCCGCGGGCTCTCATCACTAC
CGCCCGACGTTCTCTTGCCAGCAGGCCTAT|TTGACGAACAATCGCCTGAGTACATGAGGT
ACGTCGCCCGACGTTCCCCCTTGTAATATC|GCAAGAAACTAAATACGTCGCCCGACGTTC
GTCGCCCGACGTTCTGACGGCAAGAAACTA|CGTCGCCCGACGTTCCCCCTTGTAATATCG
ACGTTCATGAAACTGTCCAGGGAGATAGTG|TATAAGCTCCGATATAGGCGTTTGGCATCG
CTAAATACGTCGCCCGACGTTCACCTGCCA|CAAGTAAGCGTGTGTCACAAGTTAGACATC
ACAGGCAAGAAACTAAATACGTCGCCCGAC|AGGTGTACGACCGGGGTATCCGTGGTGAGC
AAACTAAATACGTCGCCCGACGTTCTGACG|GAAACTAAATACGTCGCCCGACGTTCCCCC
ATTAAAATCCACGCCGCAAGAAACTAAATA|AAATAAGTTACTTATTGCCGCACTCTCTCA
GGTTAAAGTGACATTTCGAAAAGGACCCAC|TTAATGATATTACTTGCGCAAGAAACTAAA
GGAGAGGGATTAAAATCCACGCCGCAAGAA|TCGAGCTTAAATAAGTTACTTATTGCCGCA
GTATAAGGAACCAGCAAGAAACTAAATACG|CAGGGAGATAGTGAGCTACCTCTTGAATAT
GATGCAAGCTACCTGTTATCAGTAGTCCGC|CTATACCGTGACGCAAGAAACTAAATACGT
TCGTTGACGAACAATCGCCTGAGTACATGA|GTAGTCCGCCATTCGCAATCGTTACTTTTT
CTATTACATGGTCTCATTATTCAAGGAGGC|GGCCCGGGCTGACAGAATCCTGTTACGTTT
AGACCGAAATAAGCGATCTTCCCGCAAGAA|TATAATTCGATTAGGGAGAGGGATTAAAAT
AAGAAACTAAATACGTCGCCCGACGTTCAG|ACGACCGGGGTATCCGTGGTGAGCAAGAAA
CTTTCACTGGGTAGTTGATAACGCCCGTTG|AACTAAATACGTCGCCCGACGTTCGGGATT
TGGTTAAAGTGACATTTCGAAAAGGACCCA|ATTAATGATATTACTTGCGCAAGAAACTAA
GGTTAAGCGTCTTAGGCTGCCGCGGGCTCT|AGAAACTAAATACGTCGCCCGACGTTCCAC
GAGTACATGAGGTCATATGAACTTCGTGCG|GTTACTTTTTACCTTTCACTGGGTAGTTGA
GGGATTAAAATCCACGCCGCAAGAAACTAA|CTTAAATAAGTTACTTATTGCCGCACTCTC
ACACTATTAATGATATTACTTGCGCAAGAA|TTCCAAGTCAAAAACATGCATCGGCGGTTA
ACTAAATACGTCGCCCGACGTTCGACTATA|GTCGCCCGACGTTCCGTGTCGAGAGTCCCA
CGTCGCCCGACGTTCGAGCTTAAATAAGTT|TTCACCTGCCAGTAAATTGGCTGAGGGGCA
GGCCTACCAACAGCAAGAAACTAAATACGT|CTACCTAGTGACTATTGACGTCACCGTTCG
CAGTAAATTGGCTGAGGGGCAATGCTAGTT|TCTCATCACCTATCGCAGCCTCGGTTCCAC
AACTAAATACGTCGCCCGACGTTCTCTTGC|CGTCACCGTTCGTTGACGAACAATCGCCTG
ATCGTTACTTTTTACCTTTCACTGGGTAGT|GTTCTGACGGCAAGAAACTAAATACGTCGC
ACTATTAATGATATTACTTGCGCAAGAAAC|CCAAGTCAAAAACATGCATCGGCGGTTAAG
GTTGATGCCGGCCTGGTCGGTGGCAAGAAA|GATTGCAAGAAACTAAATACGTCGCCCGAC
GTTCGTTGACGAACAATCGCCTGAGTACAT|CAGTAGTCCGCCATTCGCAATCGTTACTTT
TCCGATATAGGCGTTTGGCATCGGTGCTCC|TATTCAAGGAGGCCAGCAGAACCTTGTTGC
TATGAACTTCGTGCGGCACCGCGAGGGTTA|TCACTGGGTAGTTGATAACGCCCGTTGATG
AAGTTACTTATTGCCGCACTCTCTCAAAAT|GGGCAATGCTAGTTGTTGCCAATCACTATT
CAGAAAAAGTACAACAGGCAAGAAACTAAA|TCAATTCCCGAATAGGTGTACGACCGGGGT
TCGCCCGACGTTCCCAACAAGTTATAATTC|TCTGATCAGCAAGAAACTAAATACGTCGCC
AACTAAATACGTCGCCCGACGTTCGAGCTT|CGCCCGACGTTCACCTGCCAGTAAATTGGC
CGAGAGTCCCACACTATTAATGATATTACT|GTATACTTAGTTCCAAGTCAAAAACATGCA
CGACGTTCACCTGCCAGTAAATTGGCTGAG|TCACAAGTTAGACATCTCATCACCTATCGC
GGCACCGCGAGGGTTAGCAAGAAACTAAAT|ATAACGCCCGTTGATGCCGGCCTGGTCGGT
ACCTTTCACTGGGTAGTTGATAACGCCCGT|GAAACTAAATACGTCGCCCGACGTTCGGGA
GGTGAGCAAGAAACTAAATACGTCGCCCGA|CTAAATACGTCGCCCGACGTTCTCTTGCCA
AGGCCTATGTATACTTAGTTCCAAGTCAAA|CATGAGGTCATATGAACTTCGTGCGGCACC
CCGCAAGAAACTAAATACGTCGCCCGACGT|GATTAAAATCCACGCCGCAAGAAACTAAAT
GTCGCCCGACGTTCGACTATAGCTTTGGTT|CGTTCCGTGTCGAGAGTCCCACACTATTAA
CAGGCCTATGTATACTTAGTTCCAAGTCAA|ACATGAGGTCATATGAACTTCGTGCGGCAC
AAATACGTCGCCCGACGTTCACGACCTGGC|GTCTTAGGCTGCCGCGGGCTCTCATCACTA
CGTCGCGTATAAGGAACCAGCAAGAAACTA|ACTGTCCAGGGAGATAGTGAGCTACCTCTT
GTCATATGAACTTCGTGCGGCACCGCGAGG|CCTTTCACTGGGTAGTTGATAACGCCCGTT
ATTACTTGCGCAAGAAACTAAATACGTCGC|CATGCATCGGCGGTTAAGCGTCTTAGGCTG
TACGTCGCCCGACGTTCTGACGGCAAGAAA|ATACGTCGCCCGACGTTCCCCCTTGTAATA
AGTCCGCCATTCGCAATCGTTACTTTTTAC|AATACGTCGCCCGACGTTCTGACGGCAAGA
AGGAGGCCAGCAGAACCTTGTTGCCTGAGC|TACGTTTTAAAGACCGGTACACACCGTGAC
TCTTGAATATTCTGATCAGCAAGAAACTAA|AGACCTGCAAGAAACTAAATACGTCGCCCG
TAAATACGTCGCCCGACGTTCGGGATTGCA|CGAGATCGTCGCGTATAAGGAACCAGCAAG
GTAGTTGATAACGCCCGTTGATGCCGGCCT|GTCGCCCGACGTTCGGGATTGCAAGAAACT
TAAATACGTCGCCCGACGTTCTCTTGCCAG|CACCGTTCGTTGACGAACAATCGCCTGAGT
GTCGCGTATAAGGAACCAGCAAGAAACTAA|CTGTCCAGGGAGATAGTGAGCTACCTCTTG
GGTATAAGCTCCGATATAGGCGTTTGGCAT|TGGTCTCATTATTCAAGGAGGCCAGCAGAA
ATCACTATTACATGGTCTCATTATTCAAGG|CGAAGGCCCGGGCTGACAGAATCCTGTTAC
GTCCAGGGAGATAGTGAGCTACCTCTTGAA|TAGGCGTTTGGCATCGGTGCTCCAGACCTG
ATAATTCGATTAGGGAGAGGGATTAAAATC|CGTCGCCCGACGTTCGAGCTTAAATAAGTT
AACTAAATACGTCGCCCGACGTTCCACCTT|TGGTCGGTGGCAAGAAACTAAATACGTCGC
TATAGCTTTGGTTAAAGTGACATTTCGAAA|CCCACACTATTAATGATATTACTTGCGCAA
GGGTATCCGTGGTGAGCAAGAAACTAAATA|CAGCAAGAAACTAAATACGTCGCCCGACGT
CTGTCCAGGGAGATAGTGAGCTACCTCTTG|TATAGGCGTTTGGCATCGGTGCTCCAGACC
TAAATACGTCGCCCGACGTTCGAGCTTAAA|CCGACGTTCACCTGCCAGTAAATTGGCTGA
CACCTGCCAGTAAATTGGCTGAGGGGCAAT|TTAGACATCTCATCACCTATCGCAGCCTCG
AATATTCTGATCAGCAAGAAACTAAATACG|TGCAAGAAACTAAATACGTCGCCCGACGTT
CAAGAAACTAAATACGTCGCCCGACGTTCG|AAATACGTCGCCCGACGTTCCGTGTCGAGA
AAACTGTCCAGGGAGATAGTGAGCTACCTC|CGATATAGGCGTTTGGCATCGGTGCTCCAG
AACTAAATACGTCGCCCGACGTTCGACTAT|CGTCGCCCGACGTTCCGTGTCGAGAGTCCC
CGGTTAAGCGTCTTAGGCTGCCGCGGGCTC|AAGAAACTAAATACGTCGCCCGACGTTCCA
CCTAGTGACTATTGACGTCACCGTTCGTTG|CGAGATGCAAGCTACCTGTTATCAGTAGTC
TCCCACACTATTAATGATATTACTTGCGCA|TTAGTTCCAAGTCAAAAACATGCATCGGCG
TGAGCTACCTCTTGAATATTCTGATCAGCA|CGGTGCTCCAGACCTGCAAGAAACTAAATA
TGAATATTCTGATCAGCAAGAAACTAAATA|CCTGCAAGAAACTAAATACGTCGCCCGACG
AAAGTACAACAGGCAAGAAACTAAATACGT|TCCCGAATAGGTGTACGACCGGGGTATCCG
GTTCAAATACTAGACCGAAATAAGCGATCT|TCCCAACAAGTTATAATTCGATTAGGGAGA
CATGCATCGGCGGTTAAGCGTCTTAGGCTG|GAGGGTTAGCAAGAAACTAAATACGTCGCC
GAAACTAAATACGTCGCCCGACGTTCAAAT|AACTAAATACGTCGCCCGACGTTCCCAACA
CGTTCCCCCTTGTAATATCGAGATCGTCGC|AATACGTCGCCCGACGTTCATGAAACTGTC
CGGCGGTTAAGCGTCTTAGGCTGCCGCGGG|AGCAAGAAACTAAATACGTCGCCCGACGTT
CAACAAGTTATAATTCGATTAGGGAGAGGG|AACTAAATACGTCGCCCGACGTTCGAGCTT
GGGGCAATGCTAGTTGTTGCCAATCACTAT|CAGCCTCGGTTCCACATCTTTCCGAAGGCC
AGAACCTTGTTGCCTGAGCCCGCTTCGCAA|GACCGGTACACACCGTGACTTCAGGACCTC
AGCTTAAATAAGTTACTTATTGCCGCACTC|TTGGCTGAGGGGCAATGCTAGTTGTTGCCA
GTTCCGTGTCGAGAGTCCCACACTATTAAT|CAGGCCTATGTATACTTAGTTCCAAGTCAA
GCGCAAGAAACTAAATACGTCGCCCGACGT|ACTAAATACGTCGCCCGACGTTCCGTGTCG
CTGCCGCGGGCTCTCATCACTACCTAGTGA|GCCCGACGTTCCACCTTGTTCACGAGATGC
ATCGGTGCTCCAGACCTGCAAGAAACTAAA|AACCTTGTTGCCTGAGCCCGCTTCGCAAGT
CGAAATAAGCGATCTTCCCGCAAGAAACTA|ATTCGATTAGGGAGAGGGATTAAAATCCAC
CGCTTCGCAAGTAAGCGTGTGTCACAAGTT|TCAGGACCTCTTAGATGACTGCCACGAACA
CCGCGAGGGTTAGCAAGAAACTAAATACGT|CGCCCGTTGATGCCGGCCTGGTCGGTGGCA
ATTCGATTAGGGAGAGGGATTAAAATCCAC|CGCCCGACGTTCGAGCTTAAATAAGTTACT
GTTAGCAAGAAACTAAATACGTCGCCCGAC|GATGCCGGCCTGGTCGGTGGCAAGAAACTA
TCGCCCGACGTTCAGCGCAAGAAACTAAAT|GTGGTGAGCAAGAAACTAAATACGTCGCCC
GCCCGACGTTCTCTTGCCAGCAGGCCTATG|TGACGAACAATCGCCTGAGTACATGAGGTC
CATTCGCAATCGTTACTTTTTACCTTTCAC|CGCCCGACGTTCTGACGGCAAGAAACTAAA
ATAAGCGATCTTCCCGCAAGAAACTAAATA|GATTAGGGAGAGGGATTAAAATCCACGCCG
CCACGCCGCAAGAAACTAAATACGTCGCCC|TACTTATTGCCGCACTCTCTCAAAATCGTG
CTATACCGTGACGCAAGAAACTAAATACGT|AAGCGATCTTCCCGCAAGAAACTAAATACG
TACAACAGGCAAGAAACTAAATACGTCGCC|GAATAGGTGTACGACCGGGGTATCCGTGGT
TTAAGCGTCTTAGGCTGCCGCGGGCTCTCA|AAACTAAATACGTCGCCCGACGTTCCACCT
AAGTTATAATTCGATTAGGGAGAGGGATTA|AAATACGTCGCCCGACGTTCGAGCTTAAAT
CCTGTTATCAGTAGTCCGCCATTCGCAATC|CGCAAGAAACTAAATACGTCGCCCGACGTT
CAATCGCCTGAGTACATGAGGTCATATGAA|TTCGCAATCGTTACTTTTTACCTTTCACTG
ATAGGCGTTTGGCATCGGTGCTCCAGACCT|AGGAGGCCAGCAGAACCTTGTTGCCTGAGC
GTCAAAAACATGCATCGGCGGTTAAGCGTC|GGCACCGCGAGGGTTAGCAAGAAACTAAAT
CGACGTTCAGCGCAAGAAACTAAATACGTC|GAGCAAGAAACTAAATACGTCGCCCGACGT
CCCGACGTTCAAATACTAGACCGAAATAAG|CGACGTTCCCAACAAGTTATAATTCGATTA
AGATCGTCGCGTATAAGGAACCAGCAAGAA|TGAAACTGTCCAGGGAGATAGTGAGCTACC
TCCAGGGAGATAGTGAGCTACCTCTTGAAT|AGGCGTTTGGCATCGGTGCTCCAGACCTGC
AGAAACTAAATACGTCGCCCGACGTTCGAG|CGTCGCCCGACGTTCACCTGCCAGTAAATT
AAATACGTCGCCCGACGTTCCCAACAAGTT|TGAATATTCTGATCAGCAAGAAACTAAATA
GGCGGTTAAGCGTCTTAGGCTGCCGCGGGC|GCAAGAAACTAAATACGTCGCCCGACGTTC
ATGGTCTCATTATTCAAGGAGGCCAGCAGA|GCTGACAGAATCCTGTTACGTTTTAAAGAC
AATTCGATTAGGGAGAGGGATTAAAATCCA|TCGCCCGACGTTCGAGCTTAAATAAGTTAC
CGAGATCGTCGCGTATAAGGAACCAGCAAG|CATGAAACTGTCCAGGGAGATAGTGAGCTA
AAACTAAATACGTCGCCCGACGTTCCCCCT|ATCCACGCCGCAAGAAACTAAATACGTCGC
TCCCAACAAGTTATAATTCGATTAGGGAGA|AGAAACTAAATACGTCGCCCGACGTTCGAG
TAAATACGTCGCCCGACGTTCCCAACAAGT|TTGAATATTCTGATCAGCAAGAAACTAAAT
TGCAAGAAACTAAATACGTCGCCCGACGTT|CCCGCTTCGCAAGTAAGCGTGTGTCACAAG
TAAATAAGTTACTTATTGCCGCACTCTCTC|CTGAGGGGCAATGCTAGTTGTTGCCAATCA
TTCAGCGCAAGAAACTAAATACGTCGCCCG|AGAAACTAAATACGTCGCCCGACGTTCCGT
AACTAAATACGTCGCCCGACGTTCTGACGG|AAACTAAATACGTCGCCCGACGTTCCCCCT
CATGGTCTCATTATTCAAGGAGGCCAGCAG|GGCTGACAGAATCCTGTTACGTTTTAAAGA
ACTAAATACGTCGCCCGACGTTCCACCTTG|GGTCGGTGGCAAGAAACTAAATACGTCGCC
CTGATCAGCAAGAAACTAAATACGTCGCCC|AAACTAAATACGTCGCCCGACGTTCACCTG
CTGAGCCCGCTTCGCAAGTAAGCGTGTGTC|CGTGACTTCAGGACCTCTTAGATGACTGCC
ACTTTTTACCTTTCACTGGGTAGTTGATAA|ACGGCAAGAAACTAAATACGTCGCCCGACG
TAGCTTTGGTTAAAGTGACATTTCGAAAAG|CACACTATTAATGATATTACTTGCGCAAGA
AGTAAATTGGCTGAGGGGCAATGCTAGTTG|CTCATCACCTATCGCAGCCTCGGTTCCACA
ATACGTCGCCCGACGTTCGACTATAGCTTT|CCGACGTTCCGTGTCGAGAGTCCCACACTA
TGCAAGCTACCTGTTATCAGTAGTCCGCCA|ATACCGTGACGCAAGAAACTAAATACGTCG
AACTGTCCAGGGAGATAGTGAGCTACCTCT|GATATAGGCGTTTGGCATCGGTGCTCCAGA
GGATTGCAAGAAACTAAATACGTCGCCCGA|CCAGCAAGAAACTAAATACGTCGCCCGACG
CTGGTCGGTGGCAAGAAACTAAATACGTCG|CTAAATACGTCGCCCGACGTTCAAATACTA
CCTTGTTGCCTGAGCCCGCTTCGCAAGTAA|GGTACACACCGTGACTTCAGGACCTCTTAG
CATGAGGTCATATGAACTTCGTGCGGCACC|TTTTTACCTTTCACTGGGTAGTTGATAACG
GTTCAGCGCAAGAAACTAAATACGTCGCCC|AAGAAACTAAATACGTCGCCCGACGTTCCG
ACGTTCCCAACAAGTTATAATTCGATTAGG|AGCAAGAAACTAAATACGTCGCCCGACGTT
TCGATTAGGGAGAGGGATTAAAATCCACGC|CCCGACGTTCGAGCTTAAATAAGTTACTTA
ACGCCCGTTGATGCCGGCCTGGTCGGTGGC|GTTCGGGATTGCAAGAAACTAAATACGTCG
TGCTAGTTGTTGCCAATCACTATTACATGG|GGTTCCACATCTTTCCGAAGGCCCGGGCTG
CGTTCCCAACAAGTTATAATTCGATTAGGG|GCAAGAAACTAAATACGTCGCCCGACGTTC
GTCCCACACTATTAATGATATTACTTGCGC|CTTAGTTCCAAGTCAAAAACATGCATCGGC
CTACCTAGTGACTATTGACGTCACCGTTCG|TCACGAGATGCAAGCTACCTGTTATCAGTA
ACATGGTCTCATTATTCAAGGAGGCCAGCA|GGGCTGACAGAATCCTGTTACGTTTTAAAG
CGGGGTATCCGTGGTGAGCAAGAAACTAAA|AACAGCAAGAAACTAAATACGTCGCCCGAC
GACGTTCAGCGCAAGAAACTAAATACGTCG|AGCAAGAAACTAAATACGTCGCCCGACGTT
CCAGACCTGCAAGAAACTAAATACGTCGCC|GCCTGAGCCCGCTTCGCAAGTAAGCGTGTG
AGAAACTAAATACGTCGCCCGACGTTCCAC|GCCTGGTCGGTGGCAAGAAACTAAATACGT
CGCACTCTCTCAAAATCGTGGTATAAGCTC|GTTGCCAATCACTATTACATGGTCTCATTA
GTGAGCTACCTCTTGAATATTCTGATCAGC|TCGGTGCTCCAGACCTGCAAGAAACTAAAT
GCCCGACGTTCGAGCTTAAATAAGTTACTT|CCTGCCAGTAAATTGGCTGAGGGGCAATGC
CTTCGTGCGGCACCGCGAGGGTTAGCAAGA|GGTAGTTGATAACGCCCGTTGATGCCGGCC
CAAAATCGTGGTATAAGCTCCGATATAGGC|ACTATTACATGGTCTCATTATTCAAGGAGG
TGCCAGTAAATTGGCTGAGGGGCAATGCTA|ACATCTCATCACCTATCGCAGCCTCGGTTC
ACTAAATACGTCGCCCGACGTTCCGTGTCG|CCCGACGTTCTCTTGCCAGCAGGCCTATGT
GTTCATGAAACTGTCCAGGGAGATAGTGAG|TAAGCTCCGATATAGGCGTTTGGCATCGGT
CCAGGGAGATAGTGAGCTACCTCTTGAATA|GGCGTTTGGCATCGGTGCTCCAGACCTGCA
ATTATTCAAGGAGGCCAGCAGAACCTTGTT|AATCCTGTTACGTTTTAAAGACCGGTACAC
GCCCGACGTTCTGACGGCAAGAAACTAAAT|CGCCCGACGTTCCCCCTTGTAATATCGAGA
GAACCTTGTTGCCTGAGCCCGCTTCGCAAG|ACCGGTACACACCGTGACTTCAGGACCTCT
AGCAAGAAACTAAATACGTCGCCCGACGTT|CTATTGACGTCACCGTTCGTTGACGAACAA
TAACGCCCGTTGATGCCGGCCTGGTCGGTG|ACGTTCGGGATTGCAAGAAACTAAATACGT
GTCGAGAGTCCCACACTATTAATGATATTA|ATGTATACTTAGTTCCAAGTCAAAAACATG
TAGACCGAAATAAGCGATCTTCCCGCAAGA|TTATAATTCGATTAGGGAGAGGGATTAAAA
AGCGATCTTCCCGCAAGAAACTAAATACGT|TAGGGAGAGGGATTAAAATCCACGCCGCAA
GACGTTCAAATACTAGACCGAAATAAGCGA|CGTTCCCAACAAGTTATAATTCGATTAGGG
GTGGTGAGCAAGAAACTAAATACGTCGCCC|AACTAAATACGTCGCCCGACGTTCTCTTGC
ACATTTCGAAAAGGACCCACAAGGTGTATC|TACTTGCGCAAGAAACTAAATACGTCGCCC
CCGACGTTCCCCCTTGTAATATCGAGATCG|ACTAAATACGTCGCCCGACGTTCATGAAAC
AAGAAACTAAATACGTCGCCCGACGTTCAT|CCGCACTCTCTCAAAATCGTGGTATAAGCT
AAAAGTACAACAGGCAAGAAACTAAATACG|TTCCCGAATAGGTGTACGACCGGGGTATCC
TCATCACTACCTAGTGACTATTGACGTCAC|CCTTGTTCACGAGATGCAAGCTACCTGTTA
ACTATTGACGTCACCGTTCGTTGACGAACA|CAAGCTACCTGTTATCAGTAGTCCGCCATT
AAAGGACCCACAAGGTGTATCAATTCCCGA|AAGAAACTAAATACGTCGCCCGACGTTCAC
GTGACTATTGACGTCACCGTTCGTTGACGA|ATGCAAGCTACCTGTTATCAGTAGTCCGCC
TCACTATTACATGGTCTCATTATTCAAGGA|GAAGGCCCGGGCTGACAGAATCCTGTTACG
TCTCTCAAAATCGTGGTATAAGCTCCGATA|CAATCACTATTACATGGTCTCATTATTCAA
CATGAAACTGTCCAGGGAGATAGTGAGCTA|GCTCCGATATAGGCGTTTGGCATCGGTGCT
TCAAAAACATGCATCGGCGGTTAAGCGTCT|GCACCGCGAGGGTTAGCAAGAAACTAAATA
TGTTGCCTGAGCCCGCTTCGCAAGTAAGCG|ACACACCGTGACTTCAGGACCTCTTAGATG
AAATTGGCTGAGGGGCAATGCTAGTTGTTG|ATCACCTATCGCAGCCTCGGTTCCACATCT
ATACGTCGCCCGACGTTCACCTGCCAGTAA|TAAGCGTGTGTCACAAGTTAGACATCTCAT
GTCGCCCGACGTTCGGGATTGCAAGAAACT|GTCGCGTATAAGGAACCAGCAAGAAACTAA
TCGCCCGACGTTCCGTGTCGAGAGTCCCAC|TCTTGCCAGCAGGCCTATGTATACTTAGTT
GCTCCAGACCTGCAAGAAACTAAATACGTC|GTTGCCTGAGCCCGCTTCGCAAGTAAGCGT
CCGCCATTCGCAATCGTTACTTTTTACCTT|ACGTCGCCCGACGTTCTGACGGCAAGAAAC
GTACAACAGGCAAGAAACTAAATACGTCGC|CGAATAGGTGTACGACCGGGGTATCCGTGG
TGACTATTGACGTCACCGTTCGTTGACGAA|TGCAAGCTACCTGTTATCAGTAGTCCGCCA
TTCACCTGCCAGTAAATTGGCTGAGGGGCA|AGTTAGACATCTCATCACCTATCGCAGCCT
CATTATTCAAGGAGGCCAGCAGAACCTTGT|GAATCCTGTTACGTTTTAAAGACCGGTACA
ATCTTCCCGCAAGAAACTAAATACGTCGCC|GAGAGGGATTAAAATCCACGCCGCAAGAAA
CGATTAGGGAGAGGGATTAAAATCCACGCC|CCGACGTTCGAGCTTAAATAAGTTACTTAT
CCCGAATAGGTGTACGACCGGGGTATCCGT|TTCACGACCTGGCCTACCAACAGCAAGAAA
TTGCCTGAGCCCGCTTCGCAAGTAAGCGTG|ACACCGTGACTTCAGGACCTCTTAGATGAC
AACTTCGTGCGGCACCGCGAGGGTTAGCAA|TGGGTAGTTGATAACGCCCGTTGATGCCGG
TTGCCAGCAGGCCTATGTATACTTAGTTCC|CCTGAGTACATGAGGTCATATGAACTTCGT
ACTACCTAGTGACTATTGACGTCACCGTTC|TTCACGAGATGCAAGCTACCTGTTATCAGT
GGTCATATGAACTTCGTGCGGCACCGCGAG|ACCTTTCACTGGGTAGTTGATAACGCCCGT
GATTAAAATCCACGCCGCAAGAAACTAAAT|TAAATAAGTTACTTATTGCCGCACTCTCTC
ACGTTCAAATACTAGACCGAAATAAGCGAT|GTTCCCAACAAGTTATAATTCGATTAGGGA
CACCGTTCGTTGACGAACAATCGCCTGAGT|TTATCAGTAGTCCGCCATTCGCAATCGTTA
GTTATAATTCGATTAGGGAGAGGGATTAAA|ATACGTCGCCCGACGTTCGAGCTTAAATAA
TATAATTCGATTAGGGAGAGGGATTAAAAT|ACGTCGCCCGACGTTCGAGCTTAAATAAGT
AATCACTATTACATGGTCTCATTATTCAAG|CCGAAGGCCCGGGCTGACAGAATCCTGTTA
GTATAAGCTCCGATATAGGCGTTTGGCATC|GGTCTCATTATTCAAGGAGGCCAGCAGAAC
CGACCTGGCCTACCAACAGCAAGAAACTAA|TCATCACTACCTAGTGACTATTGACGTCAC
ACAAGTTATAATTCGATTAGGGAGAGGGAT|CTAAATACGTCGCCCGACGTTCGAGCTTAA
CCGGCCTGGTCGGTGGCAAGAAACTAAATA|AGAAACTAAATACGTCGCCCGACGTTCAAA
CGCAAGAAACTAAATACGTCGCCCGACGTT|ATTAAAATCCACGCCGCAAGAAACTAAATA
AAAAGGACCCACAAGGTGTATCAATTCCCG|CAAGAAACTAAATACGTCGCCCGACGTTCA
GAGATCGTCGCGTATAAGGAACCAGCAAGA|ATGAAACTGTCCAGGGAGATAGTGAGCTAC
TTCGTTGACGAACAATCGCCTGAGTACATG|AGTAGTCCGCCATTCGCAATCGTTACTTTT
TTCGAGCTTAAATAAGTTACTTATTGCCGC|TAAATTGGCTGAGGGGCAATGCTAGTTGTT
GGCAAGAAACTAAATACGTCGCCCGACGTT|TCGCCCGACGTTCAAATACTAGACCGAAAT
ACGTTCGGGATTGCAAGAAACTAAATACGT|TAAGGAACCAGCAAGAAACTAAATACGTCG
CTTGTTCACGAGATGCAAGCTACCTGTTAT|CGCCCGACGTTCTATACCGTGACGCAAGAA
TACGACCGGGGTATCCGTGGTGAGCAAGAA|CCTACCAACAGCAAGAAACTAAATACGTCG
TACGTCGCCCGACGTTCAGCGCAAGAAACT|ATCCGTGGTGAGCAAGAAACTAAATACGTC
CTCAAAATCGTGGTATAAGCTCCGATATAG|TCACTATTACATGGTCTCATTATTCAAGGA
ATAGGTGTACGACCGGGGTATCCGTGGTGA|GACCTGGCCTACCAACAGCAAGAAACTAAA
AGTTATAATTCGATTAGGGAGAGGGATTAA|AATACGTCGCCCGACGTTCGAGCTTAAATA
CCAAGTCAAAAACATGCATCGGCGGTTAAG|GTGCGGCACCGCGAGGGTTAGCAAGAAACT
GTTTGGCATCGGTGCTCCAGACCTGCAAGA|CCAGCAGAACCTTGTTGCCTGAGCCCGCTT
ATTCGCAATCGTTACTTTTTACCTTTCACT|GCCCGACGTTCTGACGGCAAGAAACTAAAT
ATAGCTTTGGTTAAAGTGACATTTCGAAAA|CCACACTATTAATGATATTACTTGCGCAAG
CGTTCACCTGCCAGTAAATTGGCTGAGGGG|CAAGTTAGACATCTCATCACCTATCGCAGC
TAAATACGTCGCCCGACGTTCTGACGGCAA|CTAAATACGTCGCCCGACGTTCCCCCTTGT
TTCTATACCGTGACGCAAGAAACTAAATAC|ATAAGCGATCTTCCCGCAAGAAACTAAATA
GTAATATCGAGATCGTCGCGTATAAGGAAC|CGACGTTCATGAAACTGTCCAGGGAGATAG
AAGAAACTAAATACGTCGCCCGACGTTCAC|GGTTAAGCGTCTTAGGCTGCCGCGGGCTCT
TCGCAATCGTTACTTTTTACCTTTCACTGG|CCGACGTTCTGACGGCAAGAAACTAAATAC
ACCGTGACGCAAGAAACTAAATACGTCGCC|GATCTTCCCGCAAGAAACTAAATACGTCGC
GCCGGCCTGGTCGGTGGCAAGAAACTAAAT|AAGAAACTAAATACGTCGCCCGACGTTCAA
CTTATTGCCGCACTCTCTCAAAATCGTGGT|TGCTAGTTGTTGCCAATCACTATTACATGG
AATACGTCGCCCGACGTTCGGGATTGCAAG|AGATCGTCGCGTATAAGGAACCAGCAAGAA
CCGACGTTCCGTGTCGAGAGTCCCACACTA|GCCAGCAGGCCTATGTATACTTAGTTCCAA
GTCACCGTTCGTTGACGAACAATCGCCTGA|TGTTATCAGTAGTCCGCCATTCGCAATCGT
ACCTGTTATCAGTAGTCCGCCATTCGCAAT|ACGCAAGAAACTAAATACGTCGCCCGACGT
ACGTTCACGACCTGGCCTACCAACAGCAAG|CGGGCTCTCATCACTACCTAGTGACTATTG
CAAGAAACTAAATACGTCGCCCGACGTTCC|GCTACCTCTTGAATATTCTGATCAGCAAGA
AGTGACTATTGACGTCACCGTTCGTTGACG|GATGCAAGCTACCTGTTATCAGTAGTCCGC
CGAATAGGTGTACGACCGGGGTATCCGTGG|CACGACCTGGCCTACCAACAGCAAGAAACT
GACGTTCTCTTGCCAGCAGGCCTATGTATA|GAACAATCGCCTGAGTACATGAGGTCATAT
GATCTTCCCGCAAGAAACTAAATACGTCGC|GGAGAGGGATTAAAATCCACGCCGCAAGAA
GCGGTTAAGCGTCTTAGGCTGCCGCGGGCT|CAAGAAACTAAATACGTCGCCCGACGTTCC
GTTCCCCCTTGTAATATCGAGATCGTCGCG|ATACGTCGCCCGACGTTCATGAAACTGTCC
CTTCCCGCAAGAAACTAAATACGTCGCCCG|GAGGGATTAAAATCCACGCCGCAAGAAACT
GTCGCCCGACGTTCCCAACAAGTTATAATT|TTCTGATCAGCAAGAAACTAAATACGTCGC
TCATATGAACTTCGTGCGGCACCGCGAGGG|CTTTCACTGGGTAGTTGATAACGCCCGTTG
AGCAAGAAACTAAATACGTCGCCCGACGTT|ATACGTCGCCCGACGTTCTCTTGCCAGCAG
ACGCAAGAAACTAAATACGTCGCCCGACGT|CCCGCAAGAAACTAAATACGTCGCCCGACG
GCAAGAAACTAAATACGTCGCCCGACGTTC|TGCCGCACTCTCTCAAAATCGTGGTATAAG
TTAGTTCCAAGTCAAAAACATGCATCGGCG|AACTTCGTGCGGCACCGCGAGGGTTAGCAA
GTTGATAACGCCCGTTGATGCCGGCCTGGT|GCCCGACGTTCGGGATTGCAAGAAACTAAA
TACGTCGCCCGACGTTCCCCCTTGTAATAT|CGCAAGAAACTAAATACGTCGCCCGACGTT
CTATTGACGTCACCGTTCGTTGACGAACAA|AAGCTACCTGTTATCAGTAGTCCGCCATTC
CTTGCGCAAGAAACTAAATACGTCGCCCGA|CATCGGCGGTTAAGCGTCTTAGGCTGCCGC
CGCCCGACGTTCCCAACAAGTTATAATTCG|CTGATCAGCAAGAAACTAAATACGTCGCCC
TGTACGACCGGGGTATCCGTGGTGAGCAAG|GGCCTACCAACAGCAAGAAACTAAATACGT
CTCTCATCACTACCTAGTGACTATTGACGT|CCACCTTGTTCACGAGATGCAAGCTACCTG
ATACGTCGCCCGACGTTCGGGATTGCAAGA|GATCGTCGCGTATAAGGAACCAGCAAGAAA
CTCATCACTACCTAGTGACTATTGACGTCA|ACCTTGTTCACGAGATGCAAGCTACCTGTT
CAATGCTAGTTGTTGCCAATCACTATTACA|CTCGGTTCCACATCTTTCCGAAGGCCCGGG
ATGCTAGTTGTTGCCAATCACTATTACATG|CGGTTCCACATCTTTCCGAAGGCCCGGGCT
GCAAGAAACTAAATACGTCGCCCGACGTTC|TAAATACGTCGCCCGACGTTCCGTGTCGAG
TACGTCGCCCGACGTTCCCAACAAGTTATA|ATATTCTGATCAGCAAGAAACTAAATACGT
AACGCCCGTTGATGCCGGCCTGGTCGGTGG|CGTTCGGGATTGCAAGAAACTAAATACGTC
CCGACGTTCACGACCTGGCCTACCAACAGC|CCGCGGGCTCTCATCACTACCTAGTGACTA
CGTTCATGAAACTGTCCAGGGAGATAGTGA|ATAAGCTCCGATATAGGCGTTTGGCATCGG
GACGTTCCACCTTGTTCACGAGATGCAAGC|CTAAATACGTCGCCCGACGTTCTATACCGT
CTGACGGCAAGAAACTAAATACGTCGCCCG|TCCCCCTTGTAATATCGAGATCGTCGCGTA
ATTGCAAGAAACTAAATACGTCGCCCGACG|AGCAAGAAACTAAATACGTCGCCCGACGTT
TTATCAGTAGTCCGCCATTCGCAATCGTTA|AGAAACTAAATACGTCGCCCGACGTTCTGA
TACGTCGCCCGACGTTCAAATACTAGACCG|CGTCGCCCGACGTTCCCAACAAGTTATAAT
TTAAATAAGTTACTTATTGCCGCACTCTCT|GCTGAGGGGCAATGCTAGTTGTTGCCAATC
GTCGCCCGACGTTCTCTTGCCAGCAGGCCT|CGTTGACGAACAATCGCCTGAGTACATGAG
ACCGCGAGGGTTAGCAAGAAACTAAATACG|ACGCCCGTTGATGCCGGCCTGGTCGGTGGC
AACATGCATCGGCGGTTAAGCGTCTTAGGC|GCGAGGGTTAGCAAGAAACTAAATACGTCG
TGCCGCGGGCTCTCATCACTACCTAGTGAC|CCCGACGTTCCACCTTGTTCACGAGATGCA
AGATAGTGAGCTACCTCTTGAATATTCTGA|TGGCATCGGTGCTCCAGACCTGCAAGAAAC
CCCGACGTTCGAGCTTAAATAAGTTACTTA|CTGCCAGTAAATTGGCTGAGGGGCAATGCT
CGTCGCCCGACGTTCTGACGGCAAGAAACT|ACGTCGCCCGACGTTCCCCCTTGTAATATC
ATTACATGGTCTCATTATTCAAGGAGGCCA|CCCGGGCTGACAGAATCCTGTTACGTTTTA
AAATACTAGACCGAAATAAGCGATCTTCCC|AACAAGTTATAATTCGATTAGGGAGAGGGA
GTTCCCAACAAGTTATAATTCGATTAGGGA|CAAGAAACTAAATACGTCGCCCGACGTTCG
CGTCGCCCGACGTTCACGACCTGGCCTACC|AGGCTGCCGCGGGCTCTCATCACTACCTAG
CCCGACGTTCACGACCTGGCCTACCAACAG|GCCGCGGGCTCTCATCACTACCTAGTGACT
CGACGTTCTATACCGTGACGCAAGAAACTA|CCGAAATAAGCGATCTTCCCGCAAGAAACT
AACTAAATACGTCGCCCGACGTTCAAATAC|CTAAATACGTCGCCCGACGTTCCCAACAAG
GACGCAAGAAACTAAATACGTCGCCCGACG|TCCCGCAAGAAACTAAATACGTCGCCCGAC
GAGGTCATATGAACTTCGTGCGGCACCGCG|TTACCTTTCACTGGGTAGTTGATAACGCCC
CCAGCAGGCCTATGTATACTTAGTTCCAAG|GAGTACATGAGGTCATATGAACTTCGTGCG
CGCCCGACGTTCATGAAACTGTCCAGGGAG|TCGTGGTATAAGCTCCGATATAGGCGTTTG
TAGGCGTTTGGCATCGGTGCTCCAGACCTG|GGAGGCCAGCAGAACCTTGTTGCCTGAGCC
GAAACTAAATACGTCGCCCGACGTTCATGA|GCACTCTCTCAAAATCGTGGTATAAGCTCC
AATACGTCGCCCGACGTTCTCTTGCCAGCA|CCGTTCGTTGACGAACAATCGCCTGAGTAC
GTGAGCAAGAAACTAAATACGTCGCCCGAC|TAAATACGTCGCCCGACGTTCTCTTGCCAG
TACCTTTCACTGGGTAGTTGATAACGCCCG|AGAAACTAAATACGTCGCCCGACGTTCGGG
TTCTGACGGCAAGAAACTAAATACGTCGCC|GTTCCCCCTTGTAATATCGAGATCGTCGCG
GTTCCAAGTCAAAAACATGCATCGGCGGTT|TTCGTGCGGCACCGCGAGGGTTAGCAAGAA
CGCAAGAAACTAAATACGTCGCCCGACGTT|GGCGGTTAAGCGTCTTAGGCTGCCGCGGGC
CTGTTATCAGTAGTCCGCCATTCGCAATCG|GCAAGAAACTAAATACGTCGCCCGACGTTC
TTCGTGCGGCACCGCGAGGGTTAGCAAGAA|GTAGTTGATAACGCCCGTTGATGCCGGCCT
TTAGGCTGCCGCGGGCTCTCATCACTACCT|ACGTCGCCCGACGTTCCACCTTGTTCACGA
CGTCACCGTTCGTTGACGAACAATCGCCTG|CTGTTATCAGTAGTCCGCCATTCGCAATCG
CCGACGTTCAGCGCAAGAAACTAAATACGT|TGAGCAAGAAACTAAATACGTCGCCCGACG
CGACCGGGGTATCCGTGGTGAGCAAGAAAC|TACCAACAGCAAGAAACTAAATACGTCGCC
ATACGTCGCCCGACGTTCACGACCTGGCCT|CTTAGGCTGCCGCGGGCTCTCATCACTACC
AGTACAACAGGCAAGAAACTAAATACGTCG|CCGAATAGGTGTACGACCGGGGTATCCGTG
TTGACGTCACCGTTCGTTGACGAACAATCG|CTACCTGTTATCAGTAGTCCGCCATTCGCA
TTTGGTTAAAGTGACATTTCGAAAAGGACC|CTATTAATGATATTACTTGCGCAAGAAACT
CTAAATACGTCGCCCGACGTTCATGAAACT|TCTCTCAAAATCGTGGTATAAGCTCCGATA
AACCAGCAAGAAACTAAATACGTCGCCCGA|TAGTGAGCTACCTCTTGAATATTCTGATCA
GGTGGCAAGAAACTAAATACGTCGCCCGAC|ACGTCGCCCGACGTTCAAATACTAGACCGA
ACGTCGCCCGACGTTCCACCTTGTTCACGA|GGCAAGAAACTAAATACGTCGCCCGACGTT
CCCGACGTTCGACTATAGCTTTGGTTAAAG|CCGTGTCGAGAGTCCCACACTATTAATGAT
TCACGAGATGCAAGCTACCTGTTATCAGTA|GACGTTCTATACCGTGACGCAAGAAACTAA
TTGTTGCCTGAGCCCGCTTCGCAAGTAAGC|TACACACCGTGACTTCAGGACCTCTTAGAT
CGACGTTCTCTTGCCAGCAGGCCTATGTAT|CGAACAATCGCCTGAGTACATGAGGTCATA
ATCGCCTGAGTACATGAGGTCATATGAACT|CGCAATCGTTACTTTTTACCTTTCACTGGG
ACCTTGTTCACGAGATGCAAGCTACCTGTT|GTCGCCCGACGTTCTATACCGTGACGCAAG
GCGTTTGGCATCGGTGCTCCAGACCTGCAA|GGCCAGCAGAACCTTGTTGCCTGAGCCCGC
CGCCTGAGTACATGAGGTCATATGAACTTC|CAATCGTTACTTTTTACCTTTCACTGGGTA
GATAGTGAGCTACCTCTTGAATATTCTGAT|GGCATCGGTGCTCCAGACCTGCAAGAAACT
GGAACCAGCAAGAAACTAAATACGTCGCCC|GATAGTGAGCTACCTCTTGAATATTCTGAT
AGTTGTTGCCAATCACTATTACATGGTCTC|CCACATCTTTCCGAAGGCCCGGGCTGACAG
CCCCTTGTAATATCGAGATCGTCGCGTATA|GTCGCCCGACGTTCATGAAACTGTCCAGGG
AGCCCGCTTCGCAAGTAAGCGTGTGTCACA|GACTTCAGGACCTCTTAGATGACTGCCACG
GCCCGACGTTCGGGATTGCAAGAAACTAAA|GCGTATAAGGAACCAGCAAGAAACTAAATA
TGACGTCACCGTTCGTTGACGAACAATCGC|TACCTGTTATCAGTAGTCCGCCATTCGCAA
TTATTGCCGCACTCTCTCAAAATCGTGGTA|GCTAGTTGTTGCCAATCACTATTACATGGT
ACTGGGTAGTTGATAACGCCCGTTGATGCC|AATACGTCGCCCGACGTTCGGGATTGCAAG
GTTGTTGCCAATCACTATTACATGGTCTCA|CACATCTTTCCGAAGGCCCGGGCTGACAGA
CACTACCTAGTGACTATTGACGTCACCGTT|GTTCACGAGATGCAAGCTACCTGTTATCAG
GTCGGTGGCAAGAAACTAAATACGTCGCCC|AATACGTCGCCCGACGTTCAAATACTAGAC
TGGTGAGCAAGAAACTAAATACGTCGCCCG|ACTAAATACGTCGCCCGACGTTCTCTTGCC
GTCGCCCGACGTTCAAATACTAGACCGAAA|CGCCCGACGTTCCCAACAAGTTATAATTCG
AACAATCGCCTGAGTACATGAGGTCATATG|CATTCGCAATCGTTACTTTTTACCTTTCAC
TCGTCGCGTATAAGGAACCAGCAAGAAACT|AACTGTCCAGGGAGATAGTGAGCTACCTCT
AGCTACCTCTTGAATATTCTGATCAGCAAG|GTGCTCCAGACCTGCAAGAAACTAAATACG
CTTTTTACCTTTCACTGGGTAGTTGATAAC|CGGCAAGAAACTAAATACGTCGCCCGACGT
TAATATCGAGATCGTCGCGTATAAGGAACC|GACGTTCATGAAACTGTCCAGGGAGATAGT
CGTCGCCCGACGTTCTCTTGCCAGCAGGCC|TCGTTGACGAACAATCGCCTGAGTACATGA
GGGCTCTCATCACTACCTAGTGACTATTGA|GTTCCACCTTGTTCACGAGATGCAAGCTAC
CTATGTATACTTAGTTCCAAGTCAAAAACA|AGGTCATATGAACTTCGTGCGGCACCGCGA
ACGTTCTATACCGTGACGCAAGAAACTAAA|GAAATAAGCGATCTTCCCGCAAGAAACTAA
GTTACTTTTTACCTTTCACTGGGTAGTTGA|CTGACGGCAAGAAACTAAATACGTCGCCCG
AAGAAACTAAATACGTCGCCCGACGTTCTC|TTGACGTCACCGTTCGTTGACGAACAATCG
CGTGGTATAAGCTCCGATATAGGCGTTTGG|ACATGGTCTCATTATTCAAGGAGGCCAGCA
AATATCGAGATCGTCGCGTATAAGGAACCA|ACGTTCATGAAACTGTCCAGGGAGATAGTG
GGGCAATGCTAGTTGTTGCCAATCACTATT|AGCCTCGGTTCCACATCTTTCCGAAGGCCC
TCACTGGGTAGTTGATAACGCCCGTTGATG|TAAATACGTCGCCCGACGTTCGGGATTGCA
TTGATGCCGGCCTGGTCGGTGGCAAGAAAC|ATTGCAAGAAACTAAATACGTCGCCCGACG
AGCTACCTGTTATCAGTAGTCCGCCATTCG|CGTGACGCAAGAAACTAAATACGTCGCCCG
TGCGGCACCGCGAGGGTTAGCAAGAAACTA|TTGATAACGCCCGTTGATGCCGGCCTGGTC
GCAAGAAACTAAATACGTCGCCCGACGTTC|CCGCTTCGCAAGTAAGCGTGTGTCACAAGT
CCGACGTTCAAATACTAGACCGAAATAAGC|GACGTTCCCAACAAGTTATAATTCGATTAG
AGAAACTAAATACGTCGCCCGACGTTCTCT|TGACGTCACCGTTCGTTGACGAACAATCGC
TGCCGCACTCTCTCAAAATCGTGGTATAAG|GTTGTTGCCAATCACTATTACATGGTCTCA
CTAAATACGTCGCCCGACGTTCCACCTTGT|GTCGGTGGCAAGAAACTAAATACGTCGCCC
GTAAATTGGCTGAGGGGCAATGCTAGTTGT|TCATCACCTATCGCAGCCTCGGTTCCACAT
TTCCCCCTTGTAATATCGAGATCGTCGCGT|TACGTCGCCCGACGTTCATGAAACTGTCCA
CCAGCAGAACCTTGTTGCCTGAGCCCGCTT|TTAAAGACCGGTACACACCGTGACTTCAGG
CCGACGTTCTGACGGCAAGAAACTAAATAC|CCCGACGTTCCCCCTTGTAATATCGAGATC
CTCTCAAAATCGTGGTATAAGCTCCGATAT|AATCACTATTACATGGTCTCATTATTCAAG
CGACGTTCCGTGTCGAGAGTCCCACACTAT|CCAGCAGGCCTATGTATACTTAGTTCCAAG
TAAATACGTCGCCCGACGTTCCCCCTTGTA|ACGCCGCAAGAAACTAAATACGTCGCCCGA
AATAAGCGATCTTCCCGCAAGAAACTAAAT|CGATTAGGGAGAGGGATTAAAATCCACGCC
AGAAACTAAATACGTCGCCCGACGTTCGAC|ATACGTCGCCCGACGTTCCGTGTCGAGAGT
TCTCATCACTACCTAGTGACTATTGACGTC|CACCTTGTTCACGAGATGCAAGCTACCTGT
ATACCGTGACGCAAGAAACTAAATACGTCG|GCGATCTTCCCGCAAGAAACTAAATACGTC
CTCCGATATAGGCGTTTGGCATCGGTGCTC|TTATTCAAGGAGGCCAGCAGAACCTTGTTG
ATACGTCGCCCGACGTTCTATACCGTGACG|AAATACTAGACCGAAATAAGCGATCTTCCC
TAGGGAGAGGGATTAAAATCCACGCCGCAA|CGTTCGAGCTTAAATAAGTTACTTATTGCC
CAACAGCAAGAAACTAAATACGTCGCCCGA|GTGACTATTGACGTCACCGTTCGTTGACGA
TCAAATACTAGACCGAAATAAGCGATCTTC|CCAACAAGTTATAATTCGATTAGGGAGAGG
CTTAGGCTGCCGCGGGCTCTCATCACTACC|TACGTCGCCCGACGTTCCACCTTGTTCACG
ACCCACAAGGTGTATCAATTCCCGAATAGG|ACTAAATACGTCGCCCGACGTTCACGACCT
CCCGTTGATGCCGGCCTGGTCGGTGGCAAG|CGGGATTGCAAGAAACTAAATACGTCGCCC
AAGCGATCTTCCCGCAAGAAACTAAATACG|TTAGGGAGAGGGATTAAAATCCACGCCGCA
TCGCCCGACGTTCAAATACTAGACCGAAAT|GCCCGACGTTCCCAACAAGTTATAATTCGA
GCAAGAAACTAAATACGTCGCCCGACGTTC|AAGAAACTAAATACGTCGCCCGACGTTCCC
AAAACATGCATCGGCGGTTAAGCGTCTTAG|CCGCGAGGGTTAGCAAGAAACTAAATACGT
TGGTATAAGCTCCGATATAGGCGTTTGGCA|ATGGTCTCATTATTCAAGGAGGCCAGCAGA
AACAGCAAGAAACTAAATACGTCGCCCGAC|TGACTATTGACGTCACCGTTCGTTGACGAA
ACGTCGCCCGACGTTCTATACCGTGACGCA|ATACTAGACCGAAATAAGCGATCTTCCCGC
AGAAACTAAATACGTCGCCCGACGTTCCCC|AAATCCACGCCGCAAGAAACTAAATACGTC
GCCCGACGTTCGACTATAGCTTTGGTTAAA|TCCGTGTCGAGAGTCCCACACTATTAATGA
GTGCGGCACCGCGAGGGTTAGCAAGAAACT|GTTGATAACGCCCGTTGATGCCGGCCTGGT
TATCAGTAGTCCGCCATTCGCAATCGTTAC|GAAACTAAATACGTCGCCCGACGTTCTGAC
CGACGTTCCACCTTGTTCACGAGATGCAAG|ACTAAATACGTCGCCCGACGTTCTATACCG
CACCGCGAGGGTTAGCAAGAAACTAAATAC|AACGCCCGTTGATGCCGGCCTGGTCGGTGG
GCCAGCAGAACCTTGTTGCCTGAGCCCGCT|TTTAAAGACCGGTACACACCGTGACTTCAG
TTACTTTTTACCTTTCACTGGGTAGTTGAT|TGACGGCAAGAAACTAAATACGTCGCCCGA
ATACGTCGCCCGACGTTCCCCCTTGTAATA|CCGCAAGAAACTAAATACGTCGCCCGACGT
AACTAAATACGTCGCCCGACGTTCATGAAA|ACTCTCTCAAAATCGTGGTATAAGCTCCGA
CAAGAAACTAAATACGTCGCCCGACGTTCC|CGGCCTGGTCGGTGGCAAGAAACTAAATAC
TTCGCAATCGTTACTTTTTACCTTTCACTG|CCCGACGTTCTGACGGCAAGAAACTAAATA
TACATGGTCTCATTATTCAAGGAGGCCAGC|CGGGCTGACAGAATCCTGTTACGTTTTAAA
TAATTCGATTAGGGAGAGGGATTAAAATCC|GTCGCCCGACGTTCGAGCTTAAATAAGTTA
GAAACTAAATACGTCGCCCGACGTTCTCTT|GACGTCACCGTTCGTTGACGAACAATCGCC
ACCGGGGTATCCGTGGTGAGCAAGAAACTA|CCAACAGCAAGAAACTAAATACGTCGCCCG
ACGTCGCCCGACGTTCGAGCTTAAATAAGT|GTTCACCTGCCAGTAAATTGGCTGAGGGGC
CGAGGGTTAGCAAGAAACTAAATACGTCGC|CCGTTGATGCCGGCCTGGTCGGTGGCAAGA
CAACAGGCAAGAAACTAAATACGTCGCCCG|ATAGGTGTACGACCGGGGTATCCGTGGTGA
AAGTCAAAAACATGCATCGGCGGTTAAGCG|GCGGCACCGCGAGGGTTAGCAAGAAACTAA
AGTACATGAGGTCATATGAACTTCGTGCGG|TTACTTTTTACCTTTCACTGGGTAGTTGAT
CCCGCTTCGCAAGTAAGCGTGTGTCACAAG|CTTCAGGACCTCTTAGATGACTGCCACGAA
CCAACAAGTTATAATTCGATTAGGGAGAGG|AAACTAAATACGTCGCCCGACGTTCGAGCT
CGACGTTCAAATACTAGACCGAAATAAGCG|ACGTTCCCAACAAGTTATAATTCGATTAGG
AAGGAGGCCAGCAGAACCTTGTTGCCTGAG|TTACGTTTTAAAGACCGGTACACACCGTGA
TCTTAGGCTGCCGCGGGCTCTCATCACTAC|ATACGTCGCCCGACGTTCCACCTTGTTCAC
GCACCGCGAGGGTTAGCAAGAAACTAAATA|TAACGCCCGTTGATGCCGGCCTGGTCGGTG
TATTACATGGTCTCATTATTCAAGGAGGCC|GCCCGGGCTGACAGAATCCTGTTACGTTTT
GACCGAAATAAGCGATCTTCCCGCAAGAAA|ATAATTCGATTAGGGAGAGGGATTAAAATC
ACTAAATACGTCGCCCGACGTTCCCCCTTG|CCACGCCGCAAGAAACTAAATACGTCGCCC
TGTCGAGAGTCCCACACTATTAATGATATT|TATGTATACTTAGTTCCAAGTCAAAAACAT
AGAGGGATTAAAATCCACGCCGCAAGAAAC|GAGCTTAAATAAGTTACTTATTGCCGCACT
CAAGAAACTAAATACGTCGCCCGACGTTCA|GCCGCACTCTCTCAAAATCGTGGTATAAGC
CAATTCCCGAATAGGTGTACGACCGGGGTA|CGACGTTCACGACCTGGCCTACCAACAGCA
GGCTGCCGCGGGCTCTCATCACTACCTAGT|TCGCCCGACGTTCCACCTTGTTCACGAGAT
ATCACTACCTAGTGACTATTGACGTCACCG|TTGTTCACGAGATGCAAGCTACCTGTTATC
AAGAAACTAAATACGTCGCCCGACGTTCGA|ACGTCGCCCGACGTTCACCTGCCAGTAAAT
GTTCGACTATAGCTTTGGTTAAAGTGACAT|CGAGAGTCCCACACTATTAATGATATTACT
AATACGTCGCCCGACGTTCGAGCTTAAATA|GACGTTCACCTGCCAGTAAATTGGCTGAGG
CGGCCTGGTCGGTGGCAAGAAACTAAATAC|GAAACTAAATACGTCGCCCGACGTTCAAAT
GCTCCGATATAGGCGTTTGGCATCGGTGCT|ATTATTCAAGGAGGCCAGCAGAACCTTGTT
GTTCCACCTTGTTCACGAGATGCAAGCTAC|AATACGTCGCCCGACGTTCTATACCGTGAC
TATAAGGAACCAGCAAGAAACTAAATACGT|AGGGAGATAGTGAGCTACCTCTTGAATATT
CGGTGCTCCAGACCTGCAAGAAACTAAATA|CCTTGTTGCCTGAGCCCGCTTCGCAAGTAA
ATTAGGGAGAGGGATTAAAATCCACGCCGC|GACGTTCGAGCTTAAATAAGTTACTTATTG
TCGTGGTATAAGCTCCGATATAGGCGTTTG|TACATGGTCTCATTATTCAAGGAGGCCAGC
TACGTCGCCCGACGTTCATGAAACTGTCCA|CAAAATCGTGGTATAAGCTCCGATATAGGC
AAGGACCCACAAGGTGTATCAATTCCCGAA|AGAAACTAAATACGTCGCCCGACGTTCACG
AAATAAGTTACTTATTGCCGCACTCTCTCA|TGAGGGGCAATGCTAGTTGTTGCCAATCAC
AGGGAGATAGTGAGCTACCTCTTGAATATT|CGTTTGGCATCGGTGCTCCAGACCTGCAAG
CTACCTGTTATCAGTAGTCCGCCATTCGCA|TGACGCAAGAAACTAAATACGTCGCCCGAC
GCTACCTCTTGAATATTCTGATCAGCAAGA|TGCTCCAGACCTGCAAGAAACTAAATACGT
CGACGTTCGACTATAGCTTTGGTTAAAGTG|GTGTCGAGAGTCCCACACTATTAATGATAT
TGCTCCAGACCTGCAAGAAACTAAATACGT|TGTTGCCTGAGCCCGCTTCGCAAGTAAGCG
CTGGCCTACCAACAGCAAGAAACTAAATAC|CACTACCTAGTGACTATTGACGTCACCGTT
GGCTCTCATCACTACCTAGTGACTATTGAC|TTCCACCTTGTTCACGAGATGCAAGCTACC
ATACGTCGCCCGACGTTCAAATACTAGACC|ACGTCGCCCGACGTTCCCAACAAGTTATAA
GATATAGGCGTTTGGCATCGGTGCTCCAGA|TCAAGGAGGCCAGCAGAACCTTGTTGCCTG
AATACTAGACCGAAATAAGCGATCTTCCCG|ACAAGTTATAATTCGATTAGGGAGAGGGAT
TCAGCGCAAGAAACTAAATACGTCGCCCGA|GAAACTAAATACGTCGCCCGACGTTCCGTG
ACTAAATACGTCGCCCGACGTTCTATACCG|CGTTCAAATACTAGACCGAAATAAGCGATC
CCCGACGTTCTATACCGTGACGCAAGAAAC|GACCGAAATAAGCGATCTTCCCGCAAGAAA
TGACGAACAATCGCCTGAGTACATGAGGTC|TCCGCCATTCGCAATCGTTACTTTTTACCT
CTCTTGCCAGCAGGCCTATGTATACTTAGT|TCGCCTGAGTACATGAGGTCATATGAACTT
ACCAGCAAGAAACTAAATACGTCGCCCGAC|AGTGAGCTACCTCTTGAATATTCTGATCAG
GCCCGACGTTCACGACCTGGCCTACCAACA|TGCCGCGGGCTCTCATCACTACCTAGTGAC
AATACGTCGCCCGACGTTCCGTGTCGAGAG|ACGTTCTCTTGCCAGCAGGCCTATGTATAC
ATACGTCGCCCGACGTTCTCTTGCCAGCAG|CGTTCGTTGACGAACAATCGCCTGAGTACA
CAAGAAACTAAATACGTCGCCCGACGTTCA|CGGTTAAGCGTCTTAGGCTGCCGCGGGCTC
CTCCAGACCTGCAAGAAACTAAATACGTCG|TTGCCTGAGCCCGCTTCGCAAGTAAGCGTG
TGGTCGGTGGCAAGAAACTAAATACGTCGC|TAAATACGTCGCCCGACGTTCAAATACTAG
CGACGTTCACGACCTGGCCTACCAACAGCA|CGCGGGCTCTCATCACTACCTAGTGACTAT
TCGCGTATAAGGAACCAGCAAGAAACTAAA|TGTCCAGGGAGATAGTGAGCTACCTCTTGA
GCCTGGTCGGTGGCAAGAAACTAAATACGT|AACTAAATACGTCGCCCGACGTTCAAATAC
TTGGTTAAAGTGACATTTCGAAAAGGACCC|TATTAATGATATTACTTGCGCAAGAAACTA
ATAAGGAACCAGCAAGAAACTAAATACGTC|GGGAGATAGTGAGCTACCTCTTGAATATTC
ACTAAATACGTCGCCCGACGTTCACCTGCC|GCAAGTAAGCGTGTGTCACAAGTTAGACAT
TACGTCGCCCGACGTTCACCTGCCAGTAAA|AAGCGTGTGTCACAAGTTAGACATCTCATC
GACCCACAAGGTGTATCAATTCCCGAATAG|AACTAAATACGTCGCCCGACGTTCACGACC
GCCCGACGTTCCGTGTCGAGAGTCCCACAC|TTGCCAGCAGGCCTATGTATACTTAGTTCC
AAACTAAATACGTCGCCCGACGTTCTATAC|GACGTTCAAATACTAGACCGAAATAAGCGA
ATAGTGAGCTACCTCTTGAATATTCTGATC|GCATCGGTGCTCCAGACCTGCAAGAAACTA
CAAGCTACCTGTTATCAGTAGTCCGCCATT|ACCGTGACGCAAGAAACTAAATACGTCGCC
CCGGGGTATCCGTGGTGAGCAAGAAACTAA|CAACAGCAAGAAACTAAATACGTCGCCCGA
GATTGCAAGAAACTAAATACGTCGCCCGAC|CAGCAAGAAACTAAATACGTCGCCCGACGT
CCTGAGCCCGCTTCGCAAGTAAGCGTGTGT|CCGTGACTTCAGGACCTCTTAGATGACTGC
TTGGCATCGGTGCTCCAGACCTGCAAGAAA|AGCAGAACCTTGTTGCCTGAGCCCGCTTCG
GACGTTCGACTATAGCTTTGGTTAAAGTGA|TGTCGAGAGTCCCACACTATTAATGATATT
ACGAGATGCAAGCTACCTGTTATCAGTAGT|CGTTCTATACCGTGACGCAAGAAACTAAAT
TTACTTATTGCCGCACTCTCTCAAAATCGT|CAATGCTAGTTGTTGCCAATCACTATTACA
CGACGTTCATGAAACTGTCCAGGGAGATAG|GGTATAAGCTCCGATATAGGCGTTTGGCAT
GCCCGACGTTCATGAAACTGTCCAGGGAGA|CGTGGTATAAGCTCCGATATAGGCGTTTGG
CGTGACGCAAGAAACTAAATACGTCGCCCG|TCTTCCCGCAAGAAACTAAATACGTCGCCC
TTCCAAGTCAAAAACATGCATCGGCGGTTA|TCGTGCGGCACCGCGAGGGTTAGCAAGAAA
AAGAAACTAAATACGTCGCCCGACGTTCAA|GAAACTAAATACGTCGCCCGACGTTCCCAA
AAGGAACCAGCAAGAAACTAAATACGTCGC|GAGATAGTGAGCTACCTCTTGAATATTCTG
TCTCATTATTCAAGGAGGCCAGCAGAACCT|ACAGAATCCTGTTACGTTTTAAAGACCGGT
TGCCAATCACTATTACATGGTCTCATTATT|CTTTCCGAAGGCCCGGGCTGACAGAATCCT
CGTCGCCCGACGTTCGACTATAGCTTTGGT|ACGTTCCGTGTCGAGAGTCCCACACTATTA
CGTCGCCCGACGTTCAAATACTAGACCGAA|TCGCCCGACGTTCCCAACAAGTTATAATTC
CGCCGCAAGAAACTAAATACGTCGCCCGAC|TTATTGCCGCACTCTCTCAAAATCGTGGTA
AAGTGACATTTCGAAAAGGACCCACAAGGT|GATATTACTTGCGCAAGAAACTAAATACGT
TCCCGAATAGGTGTACGACCGGGGTATCCG|GTTCACGACCTGGCCTACCAACAGCAAGAA
CCTGGCCTACCAACAGCAAGAAACTAAATA|TCACTACCTAGTGACTATTGACGTCACCGT
TCCACGCCGCAAGAAACTAAATACGTCGCC|TTACTTATTGCCGCACTCTCTCAAAATCGT
TGAGTACATGAGGTCATATGAACTTCGTGC|CGTTACTTTTTACCTTTCACTGGGTAGTTG
AGAAACTAAATACGTCGCCCGACGTTCAAA|AAACTAAATACGTCGCCCGACGTTCCCAAC
TTACCTTTCACTGGGTAGTTGATAACGCCC|AAGAAACTAAATACGTCGCCCGACGTTCGG
ATGAAACTGTCCAGGGAGATAGTGAGCTAC|CTCCGATATAGGCGTTTGGCATCGGTGCTC
CGATATAGGCGTTTGGCATCGGTGCTCCAG|TTCAAGGAGGCCAGCAGAACCTTGTTGCCT
CGTTCCGTGTCGAGAGTCCCACACTATTAA|GCAGGCCTATGTATACTTAGTTCCAAGTCA
CTAAATACGTCGCCCGACGTTCCCAACAAG|CTTGAATATTCTGATCAGCAAGAAACTAAA
TACATGAGGTCATATGAACTTCGTGCGGCA|ACTTTTTACCTTTCACTGGGTAGTTGATAA
TGTATCAATTCCCGAATAGGTGTACGACCG|TCGCCCGACGTTCACGACCTGGCCTACCAA
GAGGGGCAATGCTAGTTGTTGCCAATCACT|CGCAGCCTCGGTTCCACATCTTTCCGAAGG
CGAACAATCGCCTGAGTACATGAGGTCATA|GCCATTCGCAATCGTTACTTTTTACCTTTC
TTCACGACCTGGCCTACCAACAGCAAGAAA|GCTCTCATCACTACCTAGTGACTATTGACG
TCGTTACTTTTTACCTTTCACTGGGTAGTT|TTCTGACGGCAAGAAACTAAATACGTCGCC
CTACCTCTTGAATATTCTGATCAGCAAGAA|GCTCCAGACCTGCAAGAAACTAAATACGTC
ACGTTCCCCCTTGTAATATCGAGATCGTCG|AAATACGTCGCCCGACGTTCATGAAACTGT
TAGCAAGAAACTAAATACGTCGCCCGACGT|TGCCGGCCTGGTCGGTGGCAAGAAACTAAA
GAATAGGTGTACGACCGGGGTATCCGTGGT|ACGACCTGGCCTACCAACAGCAAGAAACTA
GCATCGGTGCTCCAGACCTGCAAGAAACTA|AGAACCTTGTTGCCTGAGCCCGCTTCGCAA
CTAGACCGAAATAAGCGATCTTCCCGCAAG|GTTATAATTCGATTAGGGAGAGGGATTAAA
AGACCTGCAAGAAACTAAATACGTCGCCCG|CTGAGCCCGCTTCGCAAGTAAGCGTGTGTC
CTTCGCAAGTAAGCGTGTGTCACAAGTTAG|AGGACCTCTTAGATGACTGCCACGAACAGC
ACCAACAGCAAGAAACTAAATACGTCGCCC|TAGTGACTATTGACGTCACCGTTCGTTGAC
TAGTTGATAACGCCCGTTGATGCCGGCCTG|TCGCCCGACGTTCGGGATTGCAAGAAACTA
TTCTCTTGCCAGCAGGCCTATGTATACTTA|AATCGCCTGAGTACATGAGGTCATATGAAC
ACGTCGCCCGACGTTCAGCGCAAGAAACTA|TCCGTGGTGAGCAAGAAACTAAATACGTCG
CGCCCGACGTTCCGTGTCGAGAGTCCCACA|CTTGCCAGCAGGCCTATGTATACTTAGTTC
CGCGGGCTCTCATCACTACCTAGTGACTAT|GACGTTCCACCTTGTTCACGAGATGCAAGC
GTTAAAGTGACATTTCGAAAAGGACCCACA|TAATGATATTACTTGCGCAAGAAACTAAAT
AAATACGTCGCCCGACGTTCACCTGCCAGT|AGTAAGCGTGTGTCACAAGTTAGACATCTC
TCTGATCAGCAAGAAACTAAATACGTCGCC|GAAACTAAATACGTCGCCCGACGTTCACCT
CTGCAAGAAACTAAATACGTCGCCCGACGT|GCCCGCTTCGCAAGTAAGCGTGTGTCACAA
AAATACGTCGCCCGACGTTCTGACGGCAAG|TAAATACGTCGCCCGACGTTCCCCCTTGTA
CTAAATACGTCGCCCGACGTTCTCTTGCCA|TCACCGTTCGTTGACGAACAATCGCCTGAG
CCTTGTAATATCGAGATCGTCGCGTATAAG|CGCCCGACGTTCATGAAACTGTCCAGGGAG
TGACGCAAGAAACTAAATACGTCGCCCGAC|TTCCCGCAAGAAACTAAATACGTCGCCCGA
GAAAAGGACCCACAAGGTGTATCAATTCCC|GCAAGAAACTAAATACGTCGCCCGACGTTC
TATAGGCGTTTGGCATCGGTGCTCCAGACC|AAGGAGGCCAGCAGAACCTTGTTGCCTGAG
GCCTACCAACAGCAAGAAACTAAATACGTC|TACCTAGTGACTATTGACGTCACCGTTCGT
AGTCCCACACTATTAATGATATTACTTGCG|ACTTAGTTCCAAGTCAAAAACATGCATCGG
TTAGGGAGAGGGATTAAAATCCACGCCGCA|ACGTTCGAGCTTAAATAAGTTACTTATTGC
GCCCGACGTTCTATACCGTGACGCAAGAAA|AGACCGAAATAAGCGATCTTCCCGCAAGAA
ACGTCGCCCGACGTTCAAATACTAGACCGA|GTCGCCCGACGTTCCCAACAAGTTATAATT
TGGCATCGGTGCTCCAGACCTGCAAGAAAC|GCAGAACCTTGTTGCCTGAGCCCGCTTCGC
ATGCCGGCCTGGTCGGTGGCAAGAAACTAA|GCAAGAAACTAAATACGTCGCCCGACGTTC
ATTTCGAAAAGGACCCACAAGGTGTATCAA|CTTGCGCAAGAAACTAAATACGTCGCCCGA
GACCTGGCCTACCAACAGCAAGAAACTAAA|CATCACTACCTAGTGACTATTGACGTCACC
GTTATCAGTAGTCCGCCATTCGCAATCGTT|AAGAAACTAAATACGTCGCCCGACGTTCTG
GTTAAGCGTCTTAGGCTGCCGCGGGCTCTC|GAAACTAAATACGTCGCCCGACGTTCCACC
GAGGGTTAGCAAGAAACTAAATACGTCGCC|CGTTGATGCCGGCCTGGTCGGTGGCAAGAA
ACGAACAATCGCCTGAGTACATGAGGTCAT|CGCCATTCGCAATCGTTACTTTTTACCTTT
AGGGATTAAAATCCACGCCGCAAGAAACTA|GCTTAAATAAGTTACTTATTGCCGCACTCT
GAGCTTAAATAAGTTACTTATTGCCGCACT|ATTGGCTGAGGGGCAATGCTAGTTGTTGCC
ATATGAACTTCGTGCGGCACCGCGAGGGTT|TTCACTGGGTAGTTGATAACGCCCGTTGAT
CGACGTTCGAGCTTAAATAAGTTACTTATT|GCCAGTAAATTGGCTGAGGGGCAATGCTAG
CACGACCTGGCCTACCAACAGCAAGAAACT|TCTCATCACTACCTAGTGACTATTGACGTC
CGTTGACGAACAATCGCCTGAGTACATGAG|TAGTCCGCCATTCGCAATCGTTACTTTTTA
CGCCCGACGTTCACCTGCCAGTAAATTGGC|TGTGTCACAAGTTAGACATCTCATCACCTA
GGCCTATGTATACTTAGTTCCAAGTCAAAA|ATGAGGTCATATGAACTTCGTGCGGCACCG
CGTTCTCTTGCCAGCAGGCCTATGTATACT|ACAATCGCCTGAGTACATGAGGTCATATGA
TGTCCAGGGAGATAGTGAGCTACCTCTTGA|ATAGGCGTTTGGCATCGGTGCTCCAGACCT
GAAACTAAATACGTCGCCCGACGTTCAGCG|GACCGGGGTATCCGTGGTGAGCAAGAAACT
GTGACGCAAGAAACTAAATACGTCGCCCGA|CTTCCCGCAAGAAACTAAATACGTCGCCCG
GAATATTCTGATCAGCAAGAAACTAAATAC|CTGCAAGAAACTAAATACGTCGCCCGACGT
GGGAGATAGTGAGCTACCTCTTGAATATTC|GTTTGGCATCGGTGCTCCAGACCTGCAAGA
ATTGACGTCACCGTTCGTTGACGAACAATC|GCTACCTGTTATCAGTAGTCCGCCATTCGC
CCCGACGTTCTGACGGCAAGAAACTAAATA|GCCCGACGTTCCCCCTTGTAATATCGAGAT
AGCTCCGATATAGGCGTTTGGCATCGGTGC|CATTATTCAAGGAGGCCAGCAGAACCTTGT
GAGCAAGAAACTAAATACGTCGCCCGACGT|AATACGTCGCCCGACGTTCTCTTGCCAGCA
CAGACCTGCAAGAAACTAAATACGTCGCCC|CCTGAGCCCGCTTCGCAAGTAAGCGTGTGT
CCAGTAAATTGGCTGAGGGGCAATGCTAGT|ATCTCATCACCTATCGCAGCCTCGGTTCCA
GACGTTCTGACGGCAAGAAACTAAATACGT|CGACGTTCCCCCTTGTAATATCGAGATCGT
AATACGTCGCCCGACGTTCACCTGCCAGTA|GTAAGCGTGTGTCACAAGTTAGACATCTCA
TACCGTGACGCAAGAAACTAAATACGTCGC|CGATCTTCCCGCAAGAAACTAAATACGTCG
CTAGTGACTATTGACGTCACCGTTCGTTGA|GAGATGCAAGCTACCTGTTATCAGTAGTCC
CTAAATACGTCGCCCGACGTTCAAATACTA|AAATACGTCGCCCGACGTTCCCAACAAGTT
GACGTTCACCTGCCAGTAAATTGGCTGAGG|CACAAGTTAGACATCTCATCACCTATCGCA
GCATCGGCGGTTAAGCGTCTTAGGCTGCCG|GGTTAGCAAGAAACTAAATACGTCGCCCGA
GGCGTTTGGCATCGGTGCTCCAGACCTGCA|AGGCCAGCAGAACCTTGTTGCCTGAGCCCG
TCGGTGGCAAGAAACTAAATACGTCGCCCG|ATACGTCGCCCGACGTTCAAATACTAGACC
AGGCCAGCAGAACCTTGTTGCCTGAGCCCG|GTTTTAAAGACCGGTACACACCGTGACTTC
TTACATGGTCTCATTATTCAAGGAGGCCAG|CCGGGCTGACAGAATCCTGTTACGTTTTAA
GTATCAATTCCCGAATAGGTGTACGACCGG|CGCCCGACGTTCACGACCTGGCCTACCAAC
GCGTCTTAGGCTGCCGCGGGCTCTCATCAC|TAAATACGTCGCCCGACGTTCCACCTTGTT
GAAACTAAATACGTCGCCCGACGTTCACCT|TTCGCAAGTAAGCGTGTGTCACAAGTTAGA
ACGTCGCCCGACGTTCACGACCTGGCCTAC|TAGGCTGCCGCGGGCTCTCATCACTACCTA
TTCGAAAAGGACCCACAAGGTGTATCAATT|TGCGCAAGAAACTAAATACGTCGCCCGACG
CTAAATACGTCGCCCGACGTTCACGACCTG|GCGTCTTAGGCTGCCGCGGGCTCTCATCAC
CAAGGAGGCCAGCAGAACCTTGTTGCCTGA|GTTACGTTTTAAAGACCGGTACACACCGTG
GTGTACGACCGGGGTATCCGTGGTGAGCAA|TGGCCTACCAACAGCAAGAAACTAAATACG
GGCAATGCTAGTTGTTGCCAATCACTATTA|GCCTCGGTTCCACATCTTTCCGAAGGCCCG
GTCGCCCGACGTTCGAGCTTAAATAAGTTA|TCACCTGCCAGTAAATTGGCTGAGGGGCAA
TGAGGGGCAATGCTAGTTGTTGCCAATCAC|TCGCAGCCTCGGTTCCACATCTTTCCGAAG
CGATCTTCCCGCAAGAAACTAAATACGTCG|GGGAGAGGGATTAAAATCCACGCCGCAAGA
GTTCGAGCTTAAATAAGTTACTTATTGCCG|GTAAATTGGCTGAGGGGCAATGCTAGTTGT
GTGGTATAAGCTCCGATATAGGCGTTTGGC|CATGGTCTCATTATTCAAGGAGGCCAGCAG
ACGTTCGAGCTTAAATAAGTTACTTATTGC|CAGTAAATTGGCTGAGGGGCAATGCTAGTT
AAGAAACTAAATACGTCGCCCGACGTTCAC|GCTTCGCAAGTAAGCGTGTGTCACAAGTTA
TCAATTCCCGAATAGGTGTACGACCGGGGT|CCGACGTTCACGACCTGGCCTACCAACAGC
TTTTACCTTTCACTGGGTAGTTGATAACGC|GCAAGAAACTAAATACGTCGCCCGACGTTC
CACTATTACATGGTCTCATTATTCAAGGAG|AAGGCCCGGGCTGACAGAATCCTGTTACGT
AATTCCCGAATAGGTGTACGACCGGGGTAT|GACGTTCACGACCTGGCCTACCAACAGCAA
CGCCCGACGTTCTGACGGCAAGAAACTAAA|TCGCCCGACGTTCCCCCTTGTAATATCGAG
ACATGAGGTCATATGAACTTCGTGCGGCAC|CTTTTTACCTTTCACTGGGTAGTTGATAAC
GACGTTCACGACCTGGCCTACCAACAGCAA|GCGGGCTCTCATCACTACCTAGTGACTATT
CCAACAGCAAGAAACTAAATACGTCGCCCG|AGTGACTATTGACGTCACCGTTCGTTGACG
CTAAATACGTCGCCCGACGTTCGAGCTTAA|CCCGACGTTCACCTGCCAGTAAATTGGCTG
ACTATAGCTTTGGTTAAAGTGACATTTCGA|GTCCCACACTATTAATGATATTACTTGCGC
TTAAAATCCACGCCGCAAGAAACTAAATAC|AATAAGTTACTTATTGCCGCACTCTCTCAA
ACGTCACCGTTCGTTGACGAACAATCGCCT|CCTGTTATCAGTAGTCCGCCATTCGCAATC
ATTGCCGCACTCTCTCAAAATCGTGGTATA|TAGTTGTTGCCAATCACTATTACATGGTCT
CGCAAGAAACTAAATACGTCGCCCGACGTT|TTGCCGCACTCTCTCAAAATCGTGGTATAA
GTAGTCCGCCATTCGCAATCGTTACTTTTT|TAAATACGTCGCCCGACGTTCTGACGGCAA
CCTTGTTCACGAGATGCAAGCTACCTGTTA|TCGCCCGACGTTCTATACCGTGACGCAAGA
ATACGTCGCCCGACGTTCCGTGTCGAGAGT|CGTTCTCTTGCCAGCAGGCCTATGTATACT
TGCCAGCAGGCCTATGTATACTTAGTTCCA|CTGAGTACATGAGGTCATATGAACTTCGTG
TCTATACCGTGACGCAAGAAACTAAATACG|TAAGCGATCTTCCCGCAAGAAACTAAATAC
TCGCCCGACGTTCGACTATAGCTTTGGTTA|GTTCCGTGTCGAGAGTCCCACACTATTAAT
AGGACCCACAAGGTGTATCAATTCCCGAAT|GAAACTAAATACGTCGCCCGACGTTCACGA
GCAAGAAACTAAATACGTCGCCCGACGTTC|ATACGTCGCCCGACGTTCACCTGCCAGTAA
GAGAGTCCCACACTATTAATGATATTACTT|TATACTTAGTTCCAAGTCAAAAACATGCAT
ACAACAGGCAAGAAACTAAATACGTCGCCC|AATAGGTGTACGACCGGGGTATCCGTGGTG
GCCAGCAGGCCTATGTATACTTAGTTCCAA|TGAGTACATGAGGTCATATGAACTTCGTGC
ACTAAATACGTCGCCCGACGTTCGGGATTG|ATCGAGATCGTCGCGTATAAGGAACCAGCA
CACTGGGTAGTTGATAACGCCCGTTGATGC|AAATACGTCGCCCGACGTTCGGGATTGCAA
AGTGACATTTCGAAAAGGACCCACAAGGTG|ATATTACTTGCGCAAGAAACTAAATACGTC
ACCGAAATAAGCGATCTTCCCGCAAGAAAC|TAATTCGATTAGGGAGAGGGATTAAAATCC
GGGGTATCCGTGGTGAGCAAGAAACTAAAT|ACAGCAAGAAACTAAATACGTCGCCCGACG
AATTGGCTGAGGGGCAATGCTAGTTGTTGC|TCACCTATCGCAGCCTCGGTTCCACATCTT
ACGTCGCCCGACGTTCGGGATTGCAAGAAA|TCGTCGCGTATAAGGAACCAGCAAGAAACT
AAGAAACTAAATACGTCGCCCGACGTTCGG|GTAATATCGAGATCGTCGCGTATAAGGAAC
TGATCAGCAAGAAACTAAATACGTCGCCCG|AACTAAATACGTCGCCCGACGTTCACCTGC
GCGCAAGAAACTAAATACGTCGCCCGACGT|CGGCGGTTAAGCGTCTTAGGCTGCCGCGGG
AATACGTCGCCCGACGTTCTGACGGCAAGA|AAATACGTCGCCCGACGTTCCCCCTTGTAA
GCAAGAAACTAAATACGTCGCCCGACGTTC|CGCCCGACGTTCAAATACTAGACCGAAATA
CACTCTCTCAAAATCGTGGTATAAGCTCCG|TGCCAATCACTATTACATGGTCTCATTATT
GGATTAAAATCCACGCCGCAAGAAACTAAA|TTAAATAAGTTACTTATTGCCGCACTCTCT
TCGGGATTGCAAGAAACTAAATACGTCGCC|GAACCAGCAAGAAACTAAATACGTCGCCCG
GCAAGAAACTAAATACGTCGCCCGACGTTC|AGCTACCTCTTGAATATTCTGATCAGCAAG
AGAAACTAAATACGTCGCCCGACGTTCACC|CTTCGCAAGTAAGCGTGTGTCACAAGTTAG
GGGTTAGCAAGAAACTAAATACGTCGCCCG|TTGATGCCGGCCTGGTCGGTGGCAAGAAAC
ACGTTCCACCTTGTTCACGAGATGCAAGCT|TAAATACGTCGCCCGACGTTCTATACCGTG
CGCAAGAAACTAAATACGTCGCCCGACGTT|CCGCAAGAAACTAAATACGTCGCCCGACGT
CTATTAATGATATTACTTGCGCAAGAAACT|CAAGTCAAAAACATGCATCGGCGGTTAAGC
ACTTGCGCAAGAAACTAAATACGTCGCCCG|GCATCGGCGGTTAAGCGTCTTAGGCTGCCG
TACGTCGCCCGACGTTCGACTATAGCTTTG|CGACGTTCCGTGTCGAGAGTCCCACACTAT
CAGTAGTCCGCCATTCGCAATCGTTACTTT|ACTAAATACGTCGCCCGACGTTCTGACGGC
GAAACTAAATACGTCGCCCGACGTTCCACC|CCTGGTCGGTGGCAAGAAACTAAATACGTC
TGCATCGGCGGTTAAGCGTCTTAGGCTGCC|GGGTTAGCAAGAAACTAAATACGTCGCCCG
GCCGCGGGCTCTCATCACTACCTAGTGACT|CCGACGTTCCACCTTGTTCACGAGATGCAA
ATAACGCCCGTTGATGCCGGCCTGGTCGGT|GACGTTCGGGATTGCAAGAAACTAAATACG
AACAGGCAAGAAACTAAATACGTCGCCCGA|TAGGTGTACGACCGGGGTATCCGTGGTGAG
GCTGAGGGGCAATGCTAGTTGTTGCCAATC|TATCGCAGCCTCGGTTCCACATCTTTCCGA
AACTAAATACGTCGCCCGACGTTCCGTGTC|GCCCGACGTTCTCTTGCCAGCAGGCCTATG
TCGCCCGACGTTCTCTTGCCAGCAGGCCTA|GTTGACGAACAATCGCCTGAGTACATGAGG
CAAATACTAGACCGAAATAAGCGATCTTCC|CAACAAGTTATAATTCGATTAGGGAGAGGG
CTAAATACGTCGCCCGACGTTCTATACCGT|GTTCAAATACTAGACCGAAATAAGCGATCT
GATAACGCCCGTTGATGCCGGCCTGGTCGG|CGACGTTCGGGATTGCAAGAAACTAAATAC
ACAATCGCCTGAGTACATGAGGTCATATGA|ATTCGCAATCGTTACTTTTTACCTTTCACT
TCACTACCTAGTGACTATTGACGTCACCGT|TGTTCACGAGATGCAAGCTACCTGTTATCA
GTTCACGAGATGCAAGCTACCTGTTATCAG|CCGACGTTCTATACCGTGACGCAAGAAACT
TCCGTGGTGAGCAAGAAACTAAATACGTCG|AGAAACTAAATACGTCGCCCGACGTTCTCT
CTAAATACGTCGCCCGACGTTCTGACGGCA|ACTAAATACGTCGCCCGACGTTCCCCCTTG
TTCGATTAGGGAGAGGGATTAAAATCCACG|GCCCGACGTTCGAGCTTAAATAAGTTACTT
TAAGTTACTTATTGCCGCACTCTCTCAAAA|GGGGCAATGCTAGTTGTTGCCAATCACTAT
AAAATCCACGCCGCAAGAAACTAAATACGT|TAAGTTACTTATTGCCGCACTCTCTCAAAA
ACGTCGCCCGACGTTCACCTGCCAGTAAAT|AGCGTGTGTCACAAGTTAGACATCTCATCA
CGTCGCCCGACGTTCATGAAACTGTCCAGG|AAATCGTGGTATAAGCTCCGATATAGGCGT
ACTAAATACGTCGCCCGACGTTCAGCGCAA|CGGGGTATCCGTGGTGAGCAAGAAACTAAA
GCAAGAAACTAAATACGTCGCCCGACGTTC|TACGTCGCCCGACGTTCTCTTGCCAGCAGG
TTCATGAAACTGTCCAGGGAGATAGTGAGC|AAGCTCCGATATAGGCGTTTGGCATCGGTG
TCGAGAGTCCCACACTATTAATGATATTAC|TGTATACTTAGTTCCAAGTCAAAAACATGC
AATCGTTACTTTTTACCTTTCACTGGGTAG|CGTTCTGACGGCAAGAAACTAAATACGTCG
TCGCCCGACGTTCACGACCTGGCCTACCAA|GCTGCCGCGGGCTCTCATCACTACCTAGTG
TCACGACCTGGCCTACCAACAGCAAGAAAC|CTCTCATCACTACCTAGTGACTATTGACGT
CAAGGTGTATCAATTCCCGAATAGGTGTAC|ATACGTCGCCCGACGTTCACGACCTGGCCT
GCCCGCTTCGCAAGTAAGCGTGTGTCACAA|ACTTCAGGACCTCTTAGATGACTGCCACGA
AAATACGTCGCCCGACGTTCCACCTTGTTC|CGGTGGCAAGAAACTAAATACGTCGCCCGA
GCACTCTCTCAAAATCGTGGTATAAGCTCC|TTGCCAATCACTATTACATGGTCTCATTAT
CGGTGGCAAGAAACTAAATACGTCGCCCGA|TACGTCGCCCGACGTTCAAATACTAGACCG
ACTAAATACGTCGCCCGACGTTCACGACCT|AGCGTCTTAGGCTGCCGCGGGCTCTCATCA
GGAGATAGTGAGCTACCTCTTGAATATTCT|TTTGGCATCGGTGCTCCAGACCTGCAAGAA
ACGACCTGGCCTACCAACAGCAAGAAACTA|CTCATCACTACCTAGTGACTATTGACGTCA
TCATGAAACTGTCCAGGGAGATAGTGAGCT|AGCTCCGATATAGGCGTTTGGCATCGGTGC
TACTTAGTTCCAAGTCAAAAACATGCATCG|ATGAACTTCGTGCGGCACCGCGAGGGTTAG
GGCCTGGTCGGTGGCAAGAAACTAAATACG|AAACTAAATACGTCGCCCGACGTTCAAATA
CAGCAAGAAACTAAATACGTCGCCCGACGT|ACTATTGACGTCACCGTTCGTTGACGAACA
CCCGACGTTCTCTTGCCAGCAGGCCTATGT|GACGAACAATCGCCTGAGTACATGAGGTCA
AGGGAGAGGGATTAAAATCCACGCCGCAAG|GTTCGAGCTTAAATAAGTTACTTATTGCCG
ATATTACTTGCGCAAGAAACTAAATACGTC|AACATGCATCGGCGGTTAAGCGTCTTAGGC
CGTTCACGACCTGGCCTACCAACAGCAAGA|GGGCTCTCATCACTACCTAGTGACTATTGA
ATACGTCGCCCGACGTTCGAGCTTAAATAA|ACGTTCACCTGCCAGTAAATTGGCTGAGGG
CCCAACAAGTTATAATTCGATTAGGGAGAG|GAAACTAAATACGTCGCCCGACGTTCGAGC
GAAACTAAATACGTCGCCCGACGTTCACGA|TTAAGCGTCTTAGGCTGCCGCGGGCTCTCA
CCTACCAACAGCAAGAAACTAAATACGTCG|ACCTAGTGACTATTGACGTCACCGTTCGTT
GTCGCCCGACGTTCCGTGTCGAGAGTCCCA|CTCTTGCCAGCAGGCCTATGTATACTTAGT
TACCTCTTGAATATTCTGATCAGCAAGAAA|CTCCAGACCTGCAAGAAACTAAATACGTCG
CGTGCGGCACCGCGAGGGTTAGCAAGAAAC|AGTTGATAACGCCCGTTGATGCCGGCCTGG
CGCCCGACGTTCACGACCTGGCCTACCAAC|CTGCCGCGGGCTCTCATCACTACCTAGTGA
CAAGTTATAATTCGATTAGGGAGAGGGATT|TAAATACGTCGCCCGACGTTCGAGCTTAAA
CGTTCAGCGCAAGAAACTAAATACGTCGCC|CAAGAAACTAAATACGTCGCCCGACGTTCC
ACGTTCGACTATAGCTTTGGTTAAAGTGAC|GTCGAGAGTCCCACACTATTAATGATATTA
CGTTCAAATACTAGACCGAAATAAGCGATC|TTCCCAACAAGTTATAATTCGATTAGGGAG
GTATACTTAGTTCCAAGTCAAAAACATGCA|CATATGAACTTCGTGCGGCACCGCGAGGGT
CTAAATACGTCGCCCGACGTTCAGCGCAAG|GGGGTATCCGTGGTGAGCAAGAAACTAAAT
GCCTGAGTACATGAGGTCATATGAACTTCG|AATCGTTACTTTTTACCTTTCACTGGGTAG
CTAAATACGTCGCCCGACGTTCCGTGTCGA|CCGACGTTCTCTTGCCAGCAGGCCTATGTA
GATATTACTTGCGCAAGAAACTAAATACGT|AAACATGCATCGGCGGTTAAGCGTCTTAGG
CAGAACCTTGTTGCCTGAGCCCGCTTCGCA|AGACCGGTACACACCGTGACTTCAGGACCT
AGTGAGCTACCTCTTGAATATTCTGATCAG|ATCGGTGCTCCAGACCTGCAAGAAACTAAA
GAGATAGTGAGCTACCTCTTGAATATTCTG|TTGGCATCGGTGCTCCAGACCTGCAAGAAA
ATAAGTTACTTATTGCCGCACTCTCTCAAA|AGGGGCAATGCTAGTTGTTGCCAATCACTA
GGCTGAGGGGCAATGCTAGTTGTTGCCAAT|CTATCGCAGCCTCGGTTCCACATCTTTCCG
TAAATACGTCGCCCGACGTTCGACTATAGC|CGCCCGACGTTCCGTGTCGAGAGTCCCACA
TTCCCGAATAGGTGTACGACCGGGGTATCC|CGTTCACGACCTGGCCTACCAACAGCAAGA
TCCAGACCTGCAAGAAACTAAATACGTCGC|TGCCTGAGCCCGCTTCGCAAGTAAGCGTGT
CGTGGTGAGCAAGAAACTAAATACGTCGCC|AAACTAAATACGTCGCCCGACGTTCTCTTG
TAGGCTGCCGCGGGCTCTCATCACTACCTA|CGTCGCCCGACGTTCCACCTTGTTCACGAG
TAGTCCGCCATTCGCAATCGTTACTTTTTA|AAATACGTCGCCCGACGTTCTGACGGCAAG
AATACGTCGCCCGACGTTCGACTATAGCTT|CCCGACGTTCCGTGTCGAGAGTCCCACACT
CCGACGTTCACCTGCCAGTAAATTGGCTGA|GTCACAAGTTAGACATCTCATCACCTATCG
AGCAGGCCTATGTATACTTAGTTCCAAGTC|GTACATGAGGTCATATGAACTTCGTGCGGC
AAATACGTCGCCCGACGTTCAAATACTAGA|ATACGTCGCCCGACGTTCCCAACAAGTTAT
AAACTAAATACGTCGCCCGACGTTCACGAC|TAAGCGTCTTAGGCTGCCGCGGGCTCTCAT
CCGACGTTCGGGATTGCAAGAAACTAAATA|GTATAAGGAACCAGCAAGAAACTAAATACG
TTCCGTGTCGAGAGTCCCACACTATTAATG|AGGCCTATGTATACTTAGTTCCAAGTCAAA
GAACCAGCAAGAAACTAAATACGTCGCCCG|ATAGTGAGCTACCTCTTGAATATTCTGATC
CCGCAAGAAACTAAATACGTCGCCCGACGT|ATTGCCGCACTCTCTCAAAATCGTGGTATA
GTTGACGAACAATCGCCTGAGTACATGAGG|AGTCCGCCATTCGCAATCGTTACTTTTTAC
GTTCTCTTGCCAGCAGGCCTATGTATACTT|CAATCGCCTGAGTACATGAGGTCATATGAA
GCCCGACGTTCCCCCTTGTAATATCGAGAT|AAACTAAATACGTCGCCCGACGTTCATGAA
CGTTCGTTGACGAACAATCGCCTGAGTACA|TCAGTAGTCCGCCATTCGCAATCGTTACTT
ACGGCAAGAAACTAAATACGTCGCCCGACG|CCCTTGTAATATCGAGATCGTCGCGTATAA
GCCCGACGTTCACCTGCCAGTAAATTGGCT|GTGTCACAAGTTAGACATCTCATCACCTAT
GCGATCTTCCCGCAAGAAACTAAATACGTC|AGGGAGAGGGATTAAAATCCACGCCGCAAG
TAAATACGTCGCCCGACGTTCACGACCTGG|CGTCTTAGGCTGCCGCGGGCTCTCATCACT
TTCTGATCAGCAAGAAACTAAATACGTCGC|AGAAACTAAATACGTCGCCCGACGTTCACC
AAACTAAATACGTCGCCCGACGTTCAAATA|ACTAAATACGTCGCCCGACGTTCCCAACAA
TCGCCCGACGTTCCCCCTTGTAATATCGAG|AGAAACTAAATACGTCGCCCGACGTTCATG
GACGTTCGAGCTTAAATAAGTTACTTATTG|CCAGTAAATTGGCTGAGGGGCAATGCTAGT
AGGCGTTTGGCATCGGTGCTCCAGACCTGC|GAGGCCAGCAGAACCTTGTTGCCTGAGCCC
CGCAAGAAACTAAATACGTCGCCCGACGTT|CTAAATACGTCGCCCGACGTTCCGTGTCGA
TGTAATATCGAGATCGTCGCGTATAAGGAA|CCGACGTTCATGAAACTGTCCAGGGAGATA
AGAAACTAAATACGTCGCCCGACGTTCATG|CGCACTCTCTCAAAATCGTGGTATAAGCTC
CTTTGGTTAAAGTGACATTTCGAAAAGGAC|ACTATTAATGATATTACTTGCGCAAGAAAC
GTTGCCAATCACTATTACATGGTCTCATTA|ATCTTTCCGAAGGCCCGGGCTGACAGAATC
ATATCGAGATCGTCGCGTATAAGGAACCAG|CGTTCATGAAACTGTCCAGGGAGATAGTGA
ACGTCGCCCGACGTTCATGAAACTGTCCAG|AAAATCGTGGTATAAGCTCCGATATAGGCG
TGAAACTGTCCAGGGAGATAGTGAGCTACC|TCCGATATAGGCGTTTGGCATCGGTGCTCC
CTCTCTCAAAATCGTGGTATAAGCTCCGAT|CCAATCACTATTACATGGTCTCATTATTCA
GCAAGAAACTAAATACGTCGCCCGACGTTC|TTAAAATCCACGCCGCAAGAAACTAAATAC
TTAGCAAGAAACTAAATACGTCGCCCGACG|ATGCCGGCCTGGTCGGTGGCAAGAAACTAA
ACGCCGCAAGAAACTAAATACGTCGCCCGA|CTTATTGCCGCACTCTCTCAAAATCGTGGT
TTGTAATATCGAGATCGTCGCGTATAAGGA|CCCGACGTTCATGAAACTGTCCAGGGAGAT
TAGTTGTTGCCAATCACTATTACATGGTCT|TCCACATCTTTCCGAAGGCCCGGGCTGACA
CAAGAAACTAAATACGTCGCCCGACGTTCT|ATTGACGTCACCGTTCGTTGACGAACAATC
AAGAAACTAAATACGTCGCCCGACGTTCCG|CGTCGCCCGACGTTCTCTTGCCAGCAGGCC
GTCGCCCGACGTTCAGCGCAAGAAACTAAA|CGTGGTGAGCAAGAAACTAAATACGTCGCC
TCTCAAAATCGTGGTATAAGCTCCGATATA|ATCACTATTACATGGTCTCATTATTCAAGG
AAATACGTCGCCCGACGTTCAGCGCAAGAA|GGTATCCGTGGTGAGCAAGAAACTAAATAC
AATACGTCGCCCGACGTTCAAATACTAGAC|TACGTCGCCCGACGTTCCCAACAAGTTATA
GACCGGGGTATCCGTGGTGAGCAAGAAACT|ACCAACAGCAAGAAACTAAATACGTCGCCC
TCGAAAAGGACCCACAAGGTGTATCAATTC|GCGCAAGAAACTAAATACGTCGCCCGACGT
TTTCACTGGGTAGTTGATAACGCCCGTTGA|ACTAAATACGTCGCCCGACGTTCGGGATTG
TCAAAATCGTGGTATAAGCTCCGATATAGG|CACTATTACATGGTCTCATTATTCAAGGAG
TTCAAATACTAGACCGAAATAAGCGATCTT|CCCAACAAGTTATAATTCGATTAGGGAGAG
AGAAAAAGTACAACAGGCAAGAAACTAAAT|CAATTCCCGAATAGGTGTACGACCGGGGTA
TCAGAAAAAGTACAACAGGCAAGAAACTAA|ATCAATTCCCGAATAGGTGTACGACCGGGG
TTATTCAAGGAGGCCAGCAGAACCTTGTTG|ATCCTGTTACGTTTTAAAGACCGGTACACA
GCCCGACGTTCCCAACAAGTTATAATTCGA|TGATCAGCAAGAAACTAAATACGTCGCCCG
ACCTGGCCTACCAACAGCAAGAAACTAAAT|ATCACTACCTAGTGACTATTGACGTCACCG
ATACGTCGCCCGACGTTCCCAACAAGTTAT|AATATTCTGATCAGCAAGAAACTAAATACG
GACGTTCATGAAACTGTCCAGGGAGATAGT|GTATAAGCTCCGATATAGGCGTTTGGCATC
TAAATACGTCGCCCGACGTTCATGAAACTG|CTCTCAAAATCGTGGTATAAGCTCCGATAT
CCGAAATAAGCGATCTTCCCGCAAGAAACT|AATTCGATTAGGGAGAGGGATTAAAATCCA
AAATACGTCGCCCGACGTTCTATACCGTGA|TCAAATACTAGACCGAAATAAGCGATCTTC
ACTAAATACGTCGCCCGACGTTCATGAAAC|CTCTCTCAAAATCGTGGTATAAGCTCCGAT
CCAGCAAGAAACTAAATACGTCGCCCGACG|GTGAGCTACCTCTTGAATATTCTGATCAGC
CCTGAGTACATGAGGTCATATGAACTTCGT|ATCGTTACTTTTTACCTTTCACTGGGTAGT
CTTGCCAGCAGGCCTATGTATACTTAGTTC|GCCTGAGTACATGAGGTCATATGAACTTCG
AGCGCAAGAAACTAAATACGTCGCCCGACG|AACTAAATACGTCGCCCGACGTTCCGTGTC
CGGCACCGCGAGGGTTAGCAAGAAACTAAA|GATAACGCCCGTTGATGCCGGCCTGGTCGG
AGGTCATATGAACTTCGTGCGGCACCGCGA|TACCTTTCACTGGGTAGTTGATAACGCCCG
AATACGTCGCCCGACGTTCCACCTTGTTCA|GGTGGCAAGAAACTAAATACGTCGCCCGAC
TCGCCCGACGTTCACCTGCCAGTAAATTGG|GTGTGTCACAAGTTAGACATCTCATCACCT
GAGCTACCTCTTGAATATTCTGATCAGCAA|GGTGCTCCAGACCTGCAAGAAACTAAATAC
TACGTCGCCCGACGTTCTATACCGTGACGC|AATACTAGACCGAAATAAGCGATCTTCCCG
AATCGTGGTATAAGCTCCGATATAGGCGTT|ATTACATGGTCTCATTATTCAAGGAGGCCA
ACGTCGCCCGACGTTCTGACGGCAAGAAAC|TACGTCGCCCGACGTTCCCCCTTGTAATAT
TACGTCGCCCGACGTTCTCTTGCCAGCAGG|GTTCGTTGACGAACAATCGCCTGAGTACAT
TGTATACTTAGTTCCAAGTCAAAAACATGC|TCATATGAACTTCGTGCGGCACCGCGAGGG
GAGGCCAGCAGAACCTTGTTGCCTGAGCCC|CGTTTTAAAGACCGGTACACACCGTGACTT
GAGATGCAAGCTACCTGTTATCAGTAGTCC|TTCTATACCGTGACGCAAGAAACTAAATAC
TACCTAGTGACTATTGACGTCACCGTTCGT|CACGAGATGCAAGCTACCTGTTATCAGTAG
CTAGTTGTTGCCAATCACTATTACATGGTC|TTCCACATCTTTCCGAAGGCCCGGGCTGAC
TACTTTTTACCTTTCACTGGGTAGTTGATA|GACGGCAAGAAACTAAATACGTCGCCCGAC
CGCCCGACGTTCGAGCTTAAATAAGTTACT|ACCTGCCAGTAAATTGGCTGAGGGGCAATG
ACCTTGTTGCCTGAGCCCGCTTCGCAAGTA|CGGTACACACCGTGACTTCAGGACCTCTTA
TCGAGCTTAAATAAGTTACTTATTGCCGCA|AAATTGGCTGAGGGGCAATGCTAGTTGTTG
ACGTTCACCTGCCAGTAAATTGGCTGAGGG|ACAAGTTAGACATCTCATCACCTATCGCAG
TATCCGTGGTGAGCAAGAAACTAAATACGT|CAAGAAACTAAATACGTCGCCCGACGTTCT
GAGTCCCACACTATTAATGATATTACTTGC|TACTTAGTTCCAAGTCAAAAACATGCATCG
TATTCAAGGAGGCCAGCAGAACCTTGTTGC|TCCTGTTACGTTTTAAAGACCGGTACACAC
TGACGGCAAGAAACTAAATACGTCGCCCGA|CCCCCTTGTAATATCGAGATCGTCGCGTAT
CGAGCTTAAATAAGTTACTTATTGCCGCAC|AATTGGCTGAGGGGCAATGCTAGTTGTTGC
AAATAAGCGATCTTCCCGCAAGAAACTAAA|TCGATTAGGGAGAGGGATTAAAATCCACGC
GCGGCACCGCGAGGGTTAGCAAGAAACTAA|TGATAACGCCCGTTGATGCCGGCCTGGTCG
ACATGCATCGGCGGTTAAGCGTCTTAGGCT|CGAGGGTTAGCAAGAAACTAAATACGTCGC
GCAATGCTAGTTGTTGCCAATCACTATTAC|CCTCGGTTCCACATCTTTCCGAAGGCCCGG
GCCAATCACTATTACATGGTCTCATTATTC|TTTCCGAAGGCCCGGGCTGACAGAATCCTG
TGCAAGAAACTAAATACGTCGCCCGACGTT|CAAGAAACTAAATACGTCGCCCGACGTTCC
TAAAGTGACATTTCGAAAAGGACCCACAAG|ATGATATTACTTGCGCAAGAAACTAAATAC
TATTAATGATATTACTTGCGCAAGAAACTA|AAGTCAAAAACATGCATCGGCGGTTAAGCG
GCAAGAAACTAAATACGTCGCCCGACGTTC|GTACGACCGGGGTATCCGTGGTGAGCAAGA
CCTTTCACTGGGTAGTTGATAACGCCCGTT|AAACTAAATACGTCGCCCGACGTTCGGGAT
GGGAGAGGGATTAAAATCCACGCCGCAAGA|TTCGAGCTTAAATAAGTTACTTATTGCCGC
CGTCGCCCGACGTTCGGGATTGCAAGAAAC|CGTCGCGTATAAGGAACCAGCAAGAAACTA
ACTAAATACGTCGCCCGACGTTCAAATACT|TAAATACGTCGCCCGACGTTCCCAACAAGT
CATTTCGAAAAGGACCCACAAGGTGTATCA|ACTTGCGCAAGAAACTAAATACGTCGCCCG
AGGTGTACGACCGGGGTATCCGTGGTGAGC|CCTGGCCTACCAACAGCAAGAAACTAAATA
CACCTTGTTCACGAGATGCAAGCTACCTGT|CGTCGCCCGACGTTCTATACCGTGACGCAA
CGTCGCCCGACGTTCCGTGTCGAGAGTCCC|TCTCTTGCCAGCAGGCCTATGTATACTTAG
GACTATAGCTTTGGTTAAAGTGACATTTCG|AGTCCCACACTATTAATGATATTACTTGCG
CCACAAGGTGTATCAATTCCCGAATAGGTG|TAAATACGTCGCCCGACGTTCACGACCTGG
CCGTTCGTTGACGAACAATCGCCTGAGTAC|ATCAGTAGTCCGCCATTCGCAATCGTTACT
GTGTCGAGAGTCCCACACTATTAATGATAT|CTATGTATACTTAGTTCCAAGTCAAAAACA
CCGATATAGGCGTTTGGCATCGGTGCTCCA|ATTCAAGGAGGCCAGCAGAACCTTGTTGCC
CCCGACGTTCCACCTTGTTCACGAGATGCA|AAACTAAATACGTCGCCCGACGTTCTATAC
ACTTAGTTCCAAGTCAAAAACATGCATCGG|TGAACTTCGTGCGGCACCGCGAGGGTTAGC
CCGTGTCGAGAGTCCCACACTATTAATGAT|GCCTATGTATACTTAGTTCCAAGTCAAAAA
AGATGCAAGCTACCTGTTATCAGTAGTCCG|TCTATACCGTGACGCAAGAAACTAAATACG
CAAGAAACTAAATACGTCGCCCGACGTTCA|CGCTTCGCAAGTAAGCGTGTGTCACAAGTT
AGCAGAACCTTGTTGCCTGAGCCCGCTTCG|AAAGACCGGTACACACCGTGACTTCAGGAC
ACGTTCTCTTGCCAGCAGGCCTATGTATAC|AACAATCGCCTGAGTACATGAGGTCATATG
AACTAAATACGTCGCCCGACGTTCGGGATT|TATCGAGATCGTCGCGTATAAGGAACCAGC
ATACGTCGCCCGACGTTCCACCTTGTTCAC|GTGGCAAGAAACTAAATACGTCGCCCGACG
TCTGACGGCAAGAAACTAAATACGTCGCCC|TTCCCCCTTGTAATATCGAGATCGTCGCGT
AAGAAACTAAATACGTCGCCCGACGTTCTA|CCCGACGTTCAAATACTAGACCGAAATAAG
TGGCTGAGGGGCAATGCTAGTTGTTGCCAA|CCTATCGCAGCCTCGGTTCCACATCTTTCC
GAGGGATTAAAATCCACGCCGCAAGAAACT|AGCTTAAATAAGTTACTTATTGCCGCACTC
CAAGAAACTAAATACGTCGCCCGACGTTCA|AGAAACTAAATACGTCGCCCGACGTTCCCA
CAGCAGGCCTATGTATACTTAGTTCCAAGT|AGTACATGAGGTCATATGAACTTCGTGCGG
AGCAAGAAACTAAATACGTCGCCCGACGTT|GCCGGCCTGGTCGGTGGCAAGAAACTAAAT
GCAAGAAACTAAATACGTCGCCCGACGTTC|GCGGTTAAGCGTCTTAGGCTGCCGCGGGCT
CCGCGGGCTCTCATCACTACCTAGTGACTA|CGACGTTCCACCTTGTTCACGAGATGCAAG
ATTAATGATATTACTTGCGCAAGAAACTAA|AGTCAAAAACATGCATCGGCGGTTAAGCGT
GTGACATTTCGAAAAGGACCCACAAGGTGT|TATTACTTGCGCAAGAAACTAAATACGTCG
AATACGTCGCCCGACGTTCATGAAACTGTC|CTCAAAATCGTGGTATAAGCTCCGATATAG
ATAAGCTCCGATATAGGCGTTTGGCATCGG|TCTCATTATTCAAGGAGGCCAGCAGAACCT
ATACGTCGCCCGACGTTCTGACGGCAAGAA|AATACGTCGCCCGACGTTCCCCCTTGTAAT
CGTCGCCCGACGTTCCCCCTTGTAATATCG|CAAGAAACTAAATACGTCGCCCGACGTTCA
GAAACTAAATACGTCGCCCGACGTTCGAGC|GTCGCCCGACGTTCACCTGCCAGTAAATTG
GCAAGAAACTAAATACGTCGCCCGACGTTC|CGCAAGAAACTAAATACGTCGCCCGACGTT
CAAGAAACTAAATACGTCGCCCGACGTTCA|TACGACCGGGGTATCCGTGGTGAGCAAGAA
TGCCGGCCTGGTCGGTGGCAAGAAACTAAA|CAAGAAACTAAATACGTCGCCCGACGTTCA
GCAAGAAACTAAATACGTCGCCCGACGTTC|CCGGCCTGGTCGGTGGCAAGAAACTAAATA
TATTACTTGCGCAAGAAACTAAATACGTCG|ACATGCATCGGCGGTTAAGCGTCTTAGGCT
GGCAAGAAACTAAATACGTCGCCCGACGTT|CTTGTAATATCGAGATCGTCGCGTATAAGG
GGTATCCGTGGTGAGCAAGAAACTAAATAC|AGCAAGAAACTAAATACGTCGCCCGACGTT
CCCGACGTTCCGTGTCGAGAGTCCCACACT|TGCCAGCAGGCCTATGTATACTTAGTTCCA
TTATAATTCGATTAGGGAGAGGGATTAAAA|TACGTCGCCCGACGTTCGAGCTTAAATAAG
AAACTAAATACGTCGCCCGACGTTCGGGAT|ATATCGAGATCGTCGCGTATAAGGAACCAG
TCGTGCGGCACCGCGAGGGTTAGCAAGAAA|TAGTTGATAACGCCCGTTGATGCCGGCCTG
CCGCACTCTCTCAAAATCGTGGTATAAGCT|TGTTGCCAATCACTATTACATGGTCTCATT
TACTAGACCGAAATAAGCGATCTTCCCGCA|AAGTTATAATTCGATTAGGGAGAGGGATTA
TATTGCCGCACTCTCTCAAAATCGTGGTAT|CTAGTTGTTGCCAATCACTATTACATGGTC
CGTCGCCCGACGTTCAGCGCAAGAAACTAA|CCGTGGTGAGCAAGAAACTAAATACGTCGC
ACGTTCTGACGGCAAGAAACTAAATACGTC|GACGTTCCCCCTTGTAATATCGAGATCGTC
GCTACCTGTTATCAGTAGTCCGCCATTCGC|GTGACGCAAGAAACTAAATACGTCGCCCGA
AAACTAAATACGTCGCCCGACGTTCACCTG|TCGCAAGTAAGCGTGTGTCACAAGTTAGAC
ACTTATTGCCGCACTCTCTCAAAATCGTGG|ATGCTAGTTGTTGCCAATCACTATTACATG
AGGCTGCCGCGGGCTCTCATCACTACCTAG|GTCGCCCGACGTTCCACCTTGTTCACGAGA
GTACATGAGGTCATATGAACTTCGTGCGGC|TACTTTTTACCTTTCACTGGGTAGTTGATA
GACGTTCCGTGTCGAGAGTCCCACACTATT|CAGCAGGCCTATGTATACTTAGTTCCAAGT
TCGCCCGACGTTCGGGATTGCAAGAAACTA|TCGCGTATAAGGAACCAGCAAGAAACTAAA
AACTAAATACGTCGCCCGACGTTCCCAACA|CTCTTGAATATTCTGATCAGCAAGAAACTA
CGCCATTCGCAATCGTTACTTTTTACCTTT|CGTCGCCCGACGTTCTGACGGCAAGAAACT
AGGAACCAGCAAGAAACTAAATACGTCGCC|AGATAGTGAGCTACCTCTTGAATATTCTGA
CATATGAACTTCGTGCGGCACCGCGAGGGT|TTTCACTGGGTAGTTGATAACGCCCGTTGA
TGTTATCAGTAGTCCGCCATTCGCAATCGT|CAAGAAACTAAATACGTCGCCCGACGTTCT
GTCGCCCGACGTTCCCCCTTGTAATATCGA|AAGAAACTAAATACGTCGCCCGACGTTCAT
CGACTATAGCTTTGGTTAAAGTGACATTTC|GAGTCCCACACTATTAATGATATTACTTGC
TTCGGGATTGCAAGAAACTAAATACGTCGC|GGAACCAGCAAGAAACTAAATACGTCGCCC
GCCGCACTCTCTCAAAATCGTGGTATAAGC|TTGTTGCCAATCACTATTACATGGTCTCAT
ACCTAGTGACTATTGACGTCACCGTTCGTT|ACGAGATGCAAGCTACCTGTTATCAGTAGT
AGCAAGAAACTAAATACGTCGCCCGACGTT|AATACGTCGCCCGACGTTCACCTGCCAGTA
CCTGGTCGGTGGCAAGAAACTAAATACGTC|ACTAAATACGTCGCCCGACGTTCAAATACT
TATTGACGTCACCGTTCGTTGACGAACAAT|AGCTACCTGTTATCAGTAGTCCGCCATTCG
TTAATGATATTACTTGCGCAAGAAACTAAA|GTCAAAAACATGCATCGGCGGTTAAGCGTC
AGAAACTAAATACGTCGCCCGACGTTCACG|GTTAAGCGTCTTAGGCTGCCGCGGGCTCTC
ATGCATCGGCGGTTAAGCGTCTTAGGCTGC|AGGGTTAGCAAGAAACTAAATACGTCGCCC
TAAATACGTCGCCCGACGTTCAAATACTAG|AATACGTCGCCCGACGTTCCCAACAAGTTA
CCACACTATTAATGATATTACTTGCGCAAG|AGTTCCAAGTCAAAAACATGCATCGGCGGT
ACTAAATACGTCGCCCGACGTTCGAGCTTA|GCCCGACGTTCACCTGCCAGTAAATTGGCT
CGTGTCGAGAGTCCCACACTATTAATGATA|CCTATGTATACTTAGTTCCAAGTCAAAAAC
TATGTATACTTAGTTCCAAGTCAAAAACAT|GGTCATATGAACTTCGTGCGGCACCGCGAG
CCGCTTCGCAAGTAAGCGTGTGTCACAAGT|TTCAGGACCTCTTAGATGACTGCCACGAAC
CGCCCGACGTTCCACCTTGTTCACGAGATG|AGAAACTAAATACGTCGCCCGACGTTCTAT
TTGGCTGAGGGGCAATGCTAGTTGTTGCCA|ACCTATCGCAGCCTCGGTTCCACATCTTTC
ATCAGTAGTCCGCCATTCGCAATCGTTACT|AAACTAAATACGTCGCCCGACGTTCTGACG
TCGAGATCGTCGCGTATAAGGAACCAGCAA|TCATGAAACTGTCCAGGGAGATAGTGAGCT
CATCACTACCTAGTGACTATTGACGTCACC|CTTGTTCACGAGATGCAAGCTACCTGTTAT
ATGATATTACTTGCGCAAGAAACTAAATAC|AAAAACATGCATCGGCGGTTAAGCGTCTTA
CCGTGGTGAGCAAGAAACTAAATACGTCGC|GAAACTAAATACGTCGCCCGACGTTCTCTT
TGTTCACGAGATGCAAGCTACCTGTTATCA|CCCGACGTTCTATACCGTGACGCAAGAAAC
AAATACGTCGCCCGACGTTCTCTTGCCAGC|ACCGTTCGTTGACGAACAATCGCCTGAGTA
AATAGGTGTACGACCGGGGTATCCGTGGTG|CGACCTGGCCTACCAACAGCAAGAAACTAA
CCCGACGTTCCCCCTTGTAATATCGAGATC|AACTAAATACGTCGCCCGACGTTCATGAAA
CTTGTAATATCGAGATCGTCGCGTATAAGG|GCCCGACGTTCATGAAACTGTCCAGGGAGA
GTTCACGACCTGGCCTACCAACAGCAAGAA|GGCTCTCATCACTACCTAGTGACTATTGAC
GGTCTCATTATTCAAGGAGGCCAGCAGAAC|TGACAGAATCCTGTTACGTTTTAAAGACCG
TACGTCGCCCGACGTTCGAGCTTAAATAAG|CGTTCACCTGCCAGTAAATTGGCTGAGGGG
CAGCGCAAGAAACTAAATACGTCGCCCGAC|AAACTAAATACGTCGCCCGACGTTCCGTGT
AAGAAACTAAATACGTCGCCCGACGTTCTG|CAAGAAACTAAATACGTCGCCCGACGTTCC
GACATTTCGAAAAGGACCCACAAGGTGTAT|TTACTTGCGCAAGAAACTAAATACGTCGCC
GTTCTATACCGTGACGCAAGAAACTAAATA|AATAAGCGATCTTCCCGCAAGAAACTAAAT
ATCAATTCCCGAATAGGTGTACGACCGGGG|CCCGACGTTCACGACCTGGCCTACCAACAG
ATATTCTGATCAGCAAGAAACTAAATACGT|GCAAGAAACTAAATACGTCGCCCGACGTTC
CAAGAAACTAAATACGTCGCCCGACGTTCC|ACGTCGCCCGACGTTCTCTTGCCAGCAGGC
ATCAGCAAGAAACTAAATACGTCGCCCGAC|CTAAATACGTCGCCCGACGTTCACCTGCCA
CGGGATTGCAAGAAACTAAATACGTCGCCC|AACCAGCAAGAAACTAAATACGTCGCCCGA
AAAGTGACATTTCGAAAAGGACCCACAAGG|TGATATTACTTGCGCAAGAAACTAAATACG
GCAATCGTTACTTTTTACCTTTCACTGGGT|GACGTTCTGACGGCAAGAAACTAAATACGT
TATCGAGATCGTCGCGTATAAGGAACCAGC|GTTCATGAAACTGTCCAGGGAGATAGTGAG
GCCCGACGTTCCACCTTGTTCACGAGATGC|GAAACTAAATACGTCGCCCGACGTTCTATA
GTATCCGTGGTGAGCAAGAAACTAAATACG|GCAAGAAACTAAATACGTCGCCCGACGTTC
GTCTCATTATTCAAGGAGGCCAGCAGAACC|GACAGAATCCTGTTACGTTTTAAAGACCGG
GCTTCGCAAGTAAGCGTGTGTCACAAGTTA|CAGGACCTCTTAGATGACTGCCACGAACAG
GTCGCCCGACGTTCCACCTTGTTCACGAGA|CAAGAAACTAAATACGTCGCCCGACGTTCT
GCTTTGGTTAAAGTGACATTTCGAAAAGGA|CACTATTAATGATATTACTTGCGCAAGAAA
AAGTACAACAGGCAAGAAACTAAATACGTC|CCCGAATAGGTGTACGACCGGGGTATCCGT
ATGTATACTTAGTTCCAAGTCAAAAACATG|GTCATATGAACTTCGTGCGGCACCGCGAGG
ACTATTACATGGTCTCATTATTCAAGGAGG|AGGCCCGGGCTGACAGAATCCTGTTACGTT
CCCGACGTTCGGGATTGCAAGAAACTAAAT|CGTATAAGGAACCAGCAAGAAACTAAATAC
ACTAAATACGTCGCCCGACGTTCTGACGGC|AACTAAATACGTCGCCCGACGTTCCCCCTT
CGTCGCCCGACGTTCTATACCGTGACGCAA|TACTAGACCGAAATAAGCGATCTTCCCGCA
TATAAGCTCCGATATAGGCGTTTGGCATCG|GTCTCATTATTCAAGGAGGCCAGCAGAACC
GCTAGTTGTTGCCAATCACTATTACATGGT|GTTCCACATCTTTCCGAAGGCCCGGGCTGA
CCGACGTTCCCAACAAGTTATAATTCGATT|ATCAGCAAGAAACTAAATACGTCGCCCGAC
TTGCCAATCACTATTACATGGTCTCATTAT|TCTTTCCGAAGGCCCGGGCTGACAGAATCC
CGTCTTAGGCTGCCGCGGGCTCTCATCACT|AAATACGTCGCCCGACGTTCCACCTTGTTC
TAGTGAGCTACCTCTTGAATATTCTGATCA|CATCGGTGCTCCAGACCTGCAAGAAACTAA
AGAGTCCCACACTATTAATGATATTACTTG|ATACTTAGTTCCAAGTCAAAAACATGCATC
TATCAATTCCCGAATAGGTGTACGACCGGG|GCCCGACGTTCACGACCTGGCCTACCAACA
TACGTCGCCCGACGTTCACGACCTGGCCTA|TTAGGCTGCCGCGGGCTCTCATCACTACCT
TCAGCAAGAAACTAAATACGTCGCCCGACG|TAAATACGTCGCCCGACGTTCACCTGCCAG
AGAAACTAAATACGTCGCCCGACGTTCGGG|TAATATCGAGATCGTCGCGTATAAGGAACC
CCGAATAGGTGTACGACCGGGGTATCCGTG|TCACGACCTGGCCTACCAACAGCAAGAAAC
GCTTAAATAAGTTACTTATTGCCGCACTCT|TGGCTGAGGGGCAATGCTAGTTGTTGCCAA
CGTTCGACTATAGCTTTGGTTAAAGTGACA|TCGAGAGTCCCACACTATTAATGATATTAC
TGGCCTACCAACAGCAAGAAACTAAATACG|ACTACCTAGTGACTATTGACGTCACCGTTC
CGACGTTCTGACGGCAAGAAACTAAATACG|CCGACGTTCCCCCTTGTAATATCGAGATCG
GAAAAAGTACAACAGGCAAGAAACTAAATA|AATTCCCGAATAGGTGTACGACCGGGGTAT
AATGATATTACTTGCGCAAGAAACTAAATA|CAAAAACATGCATCGGCGGTTAAGCGTCTT
CCATTCGCAATCGTTACTTTTTACCTTTCA|TCGCCCGACGTTCTGACGGCAAGAAACTAA
TTCCCAACAAGTTATAATTCGATTAGGGAG|AAGAAACTAAATACGTCGCCCGACGTTCGA
CCCACAAGGTGTATCAATTCCCGAATAGGT|CTAAATACGTCGCCCGACGTTCACGACCTG
CCCGCAAGAAACTAAATACGTCGCCCGACG|GGATTAAAATCCACGCCGCAAGAAACTAAA
CCGACGTTCGACTATAGCTTTGGTTAAAGT|CGTGTCGAGAGTCCCACACTATTAATGATA
CTAAATACGTCGCCCGACGTTCCCCCTTGT|CACGCCGCAAGAAACTAAATACGTCGCCCG
TCACCGTTCGTTGACGAACAATCGCCTGAG|GTTATCAGTAGTCCGCCATTCGCAATCGTT
ACTCTCTCAAAATCGTGGTATAAGCTCCGA|GCCAATCACTATTACATGGTCTCATTATTC
CAGCAGAACCTTGTTGCCTGAGCCCGCTTC|TAAAGACCGGTACACACCGTGACTTCAGGA
ACTAAATACGTCGCCCGACGTTCTCTTGCC|GTCACCGTTCGTTGACGAACAATCGCCTGA
CTGAGGGGCAATGCTAGTTGTTGCCAATCA|ATCGCAGCCTCGGTTCCACATCTTTCCGAA
AGGGTTAGCAAGAAACTAAATACGTCGCCC|GTTGATGCCGGCCTGGTCGGTGGCAAGAAA
AGGTGTATCAATTCCCGAATAGGTGTACGA|ACGTCGCCCGACGTTCACGACCTGGCCTAC
AGGCAAGAAACTAAATACGTCGCCCGACGT|GTGTACGACCGGGGTATCCGTGGTGAGCAA
ATGAGGTCATATGAACTTCGTGCGGCACCG|TTTTACCTTTCACTGGGTAGTTGATAACGC
AACAAGTTATAATTCGATTAGGGAGAGGGA|ACTAAATACGTCGCCCGACGTTCGAGCTTA
CTTGTTGCCTGAGCCCGCTTCGCAAGTAAG|GTACACACCGTGACTTCAGGACCTCTTAGA
TTAAAGTGACATTTCGAAAAGGACCCACAA|AATGATATTACTTGCGCAAGAAACTAAATA
CAAGAAACTAAATACGTCGCCCGACGTTCG|TGTAATATCGAGATCGTCGCGTATAAGGAA
ACTTCGTGCGGCACCGCGAGGGTTAGCAAG|GGGTAGTTGATAACGCCCGTTGATGCCGGC
AAACATGCATCGGCGGTTAAGCGTCTTAGG|CGCGAGGGTTAGCAAGAAACTAAATACGTC
TACTTGCGCAAGAAACTAAATACGTCGCCC|TGCATCGGCGGTTAAGCGTCTTAGGCTGCC
GAAACTAAATACGTCGCCCGACGTTCCCCC|AATCCACGCCGCAAGAAACTAAATACGTCG
CAAGAAACTAAATACGTCGCCCGACGTTCG|TACGTCGCCCGACGTTCACCTGCCAGTAAA
CCGACGTTCATGAAACTGTCCAGGGAGATA|TGGTATAAGCTCCGATATAGGCGTTTGGCA
AGCGTCTTAGGCTGCCGCGGGCTCTCATCA|CTAAATACGTCGCCCGACGTTCCACCTTGT
CGTCGCCCGACGTTCCCAACAAGTTATAAT|ATTCTGATCAGCAAGAAACTAAATACGTCG
GCTCTCATCACTACCTAGTGACTATTGACG|TCCACCTTGTTCACGAGATGCAAGCTACCT
CAAGTCAAAAACATGCATCGGCGGTTAAGC|TGCGGCACCGCGAGGGTTAGCAAGAAACTA
TCCACCTTGTTCACGAGATGCAAGCTACCT|TACGTCGCCCGACGTTCTATACCGTGACGC
AATAAGTTACTTATTGCCGCACTCTCTCAA|GAGGGGCAATGCTAGTTGTTGCCAATCACT
TCAAGGAGGCCAGCAGAACCTTGTTGCCTG|TGTTACGTTTTAAAGACCGGTACACACCGT
CGCCCGACGTTCAAATACTAGACCGAAATA|CCCGACGTTCCCAACAAGTTATAATTCGAT
AAGAAACTAAATACGTCGCCCGACGTTCCC|AAAATCCACGCCGCAAGAAACTAAATACGT
CGCCCGACGTTCTATACCGTGACGCAAGAA|TAGACCGAAATAAGCGATCTTCCCGCAAGA
TAAGCTCCGATATAGGCGTTTGGCATCGGT|CTCATTATTCAAGGAGGCCAGCAGAACCTT
AACTAAATACGTCGCCCGACGTTCAGCGCA|CCGGGGTATCCGTGGTGAGCAAGAAACTAA
CCTCTTGAATATTCTGATCAGCAAGAAACT|CCAGACCTGCAAGAAACTAAATACGTCGCC
TGGGTAGTTGATAACGCCCGTTGATGCCGG|TACGTCGCCCGACGTTCGGGATTGCAAGAA
TAAATTGGCTGAGGGGCAATGCTAGTTGTT|CATCACCTATCGCAGCCTCGGTTCCACATC
GGGATTGCAAGAAACTAAATACGTCGCCCG|ACCAGCAAGAAACTAAATACGTCGCCCGAC
TCGCCCGACGTTCTGACGGCAAGAAACTAA|GTCGCCCGACGTTCCCCCTTGTAATATCGA
CACGCCGCAAGAAACTAAATACGTCGCCCG|ACTTATTGCCGCACTCTCTCAAAATCGTGG
TAGTGACTATTGACGTCACCGTTCGTTGAC|AGATGCAAGCTACCTGTTATCAGTAGTCCG
ATTGGCTGAGGGGCAATGCTAGTTGTTGCC|CACCTATCGCAGCCTCGGTTCCACATCTTT
TGCCTGAGCCCGCTTCGCAAGTAAGCGTGT|CACCGTGACTTCAGGACCTCTTAGATGACT
TACTTATTGCCGCACTCTCTCAAAATCGTG|AATGCTAGTTGTTGCCAATCACTATTACAT
TTGCAAGAAACTAAATACGTCGCCCGACGT|GCAAGAAACTAAATACGTCGCCCGACGTTC
CTGGGTAGTTGATAACGCCCGTTGATGCCG|ATACGTCGCCCGACGTTCGGGATTGCAAGA
TCGACTATAGCTTTGGTTAAAGTGACATTT|AGAGTCCCACACTATTAATGATATTACTTG
ATGAACTTCGTGCGGCACCGCGAGGGTTAG|CACTGGGTAGTTGATAACGCCCGTTGATGC
TCGGCGGTTAAGCGTCTTAGGCTGCCGCGG|TAGCAAGAAACTAAATACGTCGCCCGACGT
ATTCAAGGAGGCCAGCAGAACCTTGTTGCC|CCTGTTACGTTTTAAAGACCGGTACACACC
CTCTTGAATATTCTGATCAGCAAGAAACTA|CAGACCTGCAAGAAACTAAATACGTCGCCC
TGGTCTCATTATTCAAGGAGGCCAGCAGAA|CTGACAGAATCCTGTTACGTTTTAAAGACC
AAATACGTCGCCCGACGTTCCCCCTTGTAA|CGCCGCAAGAAACTAAATACGTCGCCCGAC
TTGATAACGCCCGTTGATGCCGGCCTGGTC|CCCGACGTTCGGGATTGCAAGAAACTAAAT
GTGCTCCAGACCTGCAAGAAACTAAATACG|TTGTTGCCTGAGCCCGCTTCGCAAGTAAGC
AAGAAACTAAATACGTCGCCCGACGTTCCC|CTACCTCTTGAATATTCTGATCAGCAAGAA
TTGCCGCACTCTCTCAAAATCGTGGTATAA|AGTTGTTGCCAATCACTATTACATGGTCTC
GATGCCGGCCTGGTCGGTGGCAAGAAACTA|TGCAAGAAACTAAATACGTCGCCCGACGTT
TACGTCGCCCGACGTTCCGTGTCGAGAGTC|GTTCTCTTGCCAGCAGGCCTATGTATACTT
GGCATCGGTGCTCCAGACCTGCAAGAAACT|CAGAACCTTGTTGCCTGAGCCCGCTTCGCA
AAGCGTCTTAGGCTGCCGCGGGCTCTCATC|ACTAAATACGTCGCCCGACGTTCCACCTTG
TGATGCCGGCCTGGTCGGTGGCAAGAAACT|TTGCAAGAAACTAAATACGTCGCCCGACGT
GGACCCACAAGGTGTATCAATTCCCGAATA|AAACTAAATACGTCGCCCGACGTTCACGAC
GTGGCAAGAAACTAAATACGTCGCCCGACG|CGTCGCCCGACGTTCAAATACTAGACCGAA
AATGCTAGTTGTTGCCAATCACTATTACAT|TCGGTTCCACATCTTTCCGAAGGCCCGGGC
AAACTAAATACGTCGCCCGACGTTCGAGCT|TCGCCCGACGTTCACCTGCCAGTAAATTGG
CCCGACGTTCACCTGCCAGTAAATTGGCTG|TGTCACAAGTTAGACATCTCATCACCTATC
CGAGATGCAAGCTACCTGTTATCAGTAGTC|GTTCTATACCGTGACGCAAGAAACTAAATA
TTTTTACCTTTCACTGGGTAGTTGATAACG|GGCAAGAAACTAAATACGTCGCCCGACGTT
AGAAACTAAATACGTCGCCCGACGTTCCCA|TACCTCTTGAATATTCTGATCAGCAAGAAA
ACAGCAAGAAACTAAATACGTCGCCCGACG|GACTATTGACGTCACCGTTCGTTGACGAAC
ATACGTCGCCCGACGTTCATGAAACTGTCC|TCAAAATCGTGGTATAAGCTCCGATATAGG
CAGCAAGAAACTAAATACGTCGCCCGACGT|AAATACGTCGCCCGACGTTCACCTGCCAGT
TTCACGAGATGCAAGCTACCTGTTATCAGT|CGACGTTCTATACCGTGACGCAAGAAACTA
GAAACTAAATACGTCGCCCGACGTTCGACT|TACGTCGCCCGACGTTCCGTGTCGAGAGTC
CTTAGTTCCAAGTCAAAAACATGCATCGGC|GAACTTCGTGCGGCACCGCGAGGGTTAGCA
GTCGCCCGACGTTCACGACCTGGCCTACCA|GGCTGCCGCGGGCTCTCATCACTACCTAGT
CTAAATACGTCGCCCGACGTTCGGGATTGC|TCGAGATCGTCGCGTATAAGGAACCAGCAA
CTAAATACGTCGCCCGACGTTCGACTATAG|TCGCCCGACGTTCCGTGTCGAGAGTCCCAC
TACCAACAGCAAGAAACTAAATACGTCGCC|CTAGTGACTATTGACGTCACCGTTCGTTGA
TGACATTTCGAAAAGGACCCACAAGGTGTA|ATTACTTGCGCAAGAAACTAAATACGTCGC
ACGTTCCGTGTCGAGAGTCCCACACTATTA|AGCAGGCCTATGTATACTTAGTTCCAAGTC
GGCCAGCAGAACCTTGTTGCCTGAGCCCGC|TTTTAAAGACCGGTACACACCGTGACTTCA
AAACTAAATACGTCGCCCGACGTTCTCTTG|ACGTCACCGTTCGTTGACGAACAATCGCCT
CGTTCGGGATTGCAAGAAACTAAATACGTC|AAGGAACCAGCAAGAAACTAAATACGTCGC
TCCGTGTCGAGAGTCCCACACTATTAATGA|GGCCTATGTATACTTAGTTCCAAGTCAAAA
AGAAACTAAATACGTCGCCCGACGTTCTAT|CCGACGTTCAAATACTAGACCGAAATAAGC
CAGGGAGATAGTGAGCTACCTCTTGAATAT|GCGTTTGGCATCGGTGCTCCAGACCTGCAA
TGATATTACTTGCGCAAGAAACTAAATACG|AAAACATGCATCGGCGGTTAAGCGTCTTAG
AAGGTGTATCAATTCCCGAATAGGTGTACG|TACGTCGCCCGACGTTCACGACCTGGCCTA
TCTTGCCAGCAGGCCTATGTATACTTAGTT|CGCCTGAGTACATGAGGTCATATGAACTTC
GATCAGCAAGAAACTAAATACGTCGCCCGA|ACTAAATACGTCGCCCGACGTTCACCTGCC
CAGCAAGAAACTAAATACGTCGCCCGACGT|TGAGCTACCTCTTGAATATTCTGATCAGCA
CTACCAACAGCAAGAAACTAAATACGTCGC|CCTAGTGACTATTGACGTCACCGTTCGTTG
CATCGGCGGTTAAGCGTCTTAGGCTGCCGC|GTTAGCAAGAAACTAAATACGTCGCCCGAC
AAATACGTCGCCCGACGTTCGAGCTTAAAT|CGACGTTCACCTGCCAGTAAATTGGCTGAG
CGTCGCCCGACGTTCCACCTTGTTCACGAG|GCAAGAAACTAAATACGTCGCCCGACGTTC
GTCCGCCATTCGCAATCGTTACTTTTTACC|ATACGTCGCCCGACGTTCTGACGGCAAGAA
CAAAAACATGCATCGGCGGTTAAGCGTCTT|CACCGCGAGGGTTAGCAAGAAACTAAATAC
AAACTAAATACGTCGCCCGACGTTCCGTGT|CGCCCGACGTTCTCTTGCCAGCAGGCCTAT
GCCATTCGCAATCGTTACTTTTTACCTTTC|GTCGCCCGACGTTCTGACGGCAAGAAACTA
GCCTGAGCCCGCTTCGCAAGTAAGCGTGTG|ACCGTGACTTCAGGACCTCTTAGATGACTG
GCCCGTTGATGCCGGCCTGGTCGGTGGCAA|TCGGGATTGCAAGAAACTAAATACGTCGCC
CGTCGCCCGACGTTCACCTGCCAGTAAATT|GCGTGTGTCACAAGTTAGACATCTCATCAC
ATCGGCGGTTAAGCGTCTTAGGCTGCCGCG|TTAGCAAGAAACTAAATACGTCGCCCGACG
AAGCTCCGATATAGGCGTTTGGCATCGGTG|TCATTATTCAAGGAGGCCAGCAGAACCTTG
CTGAGTACATGAGGTCATATGAACTTCGTG|TCGTTACTTTTTACCTTTCACTGGGTAGTT
TAGTTCCAAGTCAAAAACATGCATCGGCGG|ACTTCGTGCGGCACCGCGAGGGTTAGCAAG
ACGTCGCCCGACGTTCTCTTGCCAGCAGGC|TTCGTTGACGAACAATCGCCTGAGTACATG
GGTGTATCAATTCCCGAATAGGTGTACGAC|CGTCGCCCGACGTTCACGACCTGGCCTACC
CTTGAATATTCTGATCAGCAAGAAACTAAA|GACCTGCAAGAAACTAAATACGTCGCCCGA
GACGTTCGGGATTGCAAGAAACTAAATACG|ATAAGGAACCAGCAAGAAACTAAATACGTC
AAACTAAATACGTCGCCCGACGTTCGACTA|ACGTCGCCCGACGTTCCGTGTCGAGAGTCC
TCGCCTGAGTACATGAGGTCATATGAACTT|GCAATCGTTACTTTTTACCTTTCACTGGGT
TTGTTGCCAATCACTATTACATGGTCTCAT|ACATCTTTCCGAAGGCCCGGGCTGACAGAA
AGAAACTAAATACGTCGCCCGACGTTCAGC|CGACCGGGGTATCCGTGGTGAGCAAGAAAC
TGAGGTCATATGAACTTCGTGCGGCACCGC|TTTACCTTTCACTGGGTAGTTGATAACGCC
GATCGTCGCGTATAAGGAACCAGCAAGAAA|GAAACTGTCCAGGGAGATAGTGAGCTACCT
ATTCTGATCAGCAAGAAACTAAATACGTCG|AAGAAACTAAATACGTCGCCCGACGTTCAC
ATACGTCGCCCGACGTTCAGCGCAAGAAAC|TATCCGTGGTGAGCAAGAAACTAAATACGT
GCAAGAAACTAAATACGTCGCCCGACGTTC|TATTGACGTCACCGTTCGTTGACGAACAAT
CACAAGGTGTATCAATTCCCGAATAGGTGT|AAATACGTCGCCCGACGTTCACGACCTGGC
CCCGACGTTCAGCGCAAGAAACTAAATACG|GTGAGCAAGAAACTAAATACGTCGCCCGAC
CACTATTAATGATATTACTTGCGCAAGAAA|TCCAAGTCAAAAACATGCATCGGCGGTTAA
TATTCTGATCAGCAAGAAACTAAATACGTC|CAAGAAACTAAATACGTCGCCCGACGTTCA
GACGTTCTATACCGTGACGCAAGAAACTAA|CGAAATAAGCGATCTTCCCGCAAGAAACTA
CGTATAAGGAACCAGCAAGAAACTAAATAC|CCAGGGAGATAGTGAGCTACCTCTTGAATA
AGAAACTAAATACGTCGCCCGACGTTCCGT|GTCGCCCGACGTTCTCTTGCCAGCAGGCCT
GAAACTAAATACGTCGCCCGACGTTCTGAC|AGAAACTAAATACGTCGCCCGACGTTCCCC
CGCCCGACGTTCGGGATTGCAAGAAACTAA|CGCGTATAAGGAACCAGCAAGAAACTAAAT
GCCAGTAAATTGGCTGAGGGGCAATGCTAG|CATCTCATCACCTATCGCAGCCTCGGTTCC
AGTAGTCCGCCATTCGCAATCGTTACTTTT|CTAAATACGTCGCCCGACGTTCTGACGGCA
TCTTCCCGCAAGAAACTAAATACGTCGCCC|AGAGGGATTAAAATCCACGCCGCAAGAAAC
AGTTGATAACGCCCGTTGATGCCGGCCTGG|CGCCCGACGTTCGGGATTGCAAGAAACTAA
ACGTTCAGCGCAAGAAACTAAATACGTCGC|GCAAGAAACTAAATACGTCGCCCGACGTTC
GAAACTAAATACGTCGCCCGACGTTCGGGA|AATATCGAGATCGTCGCGTATAAGGAACCA
AACTAAATACGTCGCCCGACGTTCCCCCTT|TCCACGCCGCAAGAAACTAAATACGTCGCC
AATACGTCGCCCGACGTTCCCCCTTGTAAT|GCCGCAAGAAACTAAATACGTCGCCCGACG
GGTTAGCAAGAAACTAAATACGTCGCCCGA|TGATGCCGGCCTGGTCGGTGGCAAGAAACT
AAAAAGTACAACAGGCAAGAAACTAAATAC|ATTCCCGAATAGGTGTACGACCGGGGTATC
TTCCACCTTGTTCACGAGATGCAAGCTACC|ATACGTCGCCCGACGTTCTATACCGTGACG
ACTAGACCGAAATAAGCGATCTTCCCGCAA|AGTTATAATTCGATTAGGGAGAGGGATTAA
CCCACACTATTAATGATATTACTTGCGCAA|TAGTTCCAAGTCAAAAACATGCATCGGCGG
AAATACGTCGCCCGACGTTCATGAAACTGT|TCTCAAAATCGTGGTATAAGCTCCGATATA
AACTAAATACGTCGCCCGACGTTCTATACC|ACGTTCAAATACTAGACCGAAATAAGCGAT
TAAATACGTCGCCCGACGTTCCACCTTGTT|TCGGTGGCAAGAAACTAAATACGTCGCCCG
CACACTATTAATGATATTACTTGCGCAAGA|GTTCCAAGTCAAAAACATGCATCGGCGGTT
GCGGGCTCTCATCACTACCTAGTGACTATT|ACGTTCCACCTTGTTCACGAGATGCAAGCT
GACGTTCCCCCTTGTAATATCGAGATCGTC|TAAATACGTCGCCCGACGTTCATGAAACTG
AAATCCACGCCGCAAGAAACTAAATACGTC|AAGTTACTTATTGCCGCACTCTCTCAAAAT
CTATAGCTTTGGTTAAAGTGACATTTCGAA|TCCCACACTATTAATGATATTACTTGCGCA
GCAAGAAACTAAATACGTCGCCCGACGTTC|TTGTAATATCGAGATCGTCGCGTATAAGGA
GTCGCCCGACGTTCACCTGCCAGTAAATTG|CGTGTGTCACAAGTTAGACATCTCATCACC
TTGACGAACAATCGCCTGAGTACATGAGGT|GTCCGCCATTCGCAATCGTTACTTTTTACC
TTCACTGGGTAGTTGATAACGCCCGTTGAT|CTAAATACGTCGCCCGACGTTCGGGATTGC
GTCTTAGGCTGCCGCGGGCTCTCATCACTA|AATACGTCGCCCGACGTTCCACCTTGTTCA
TTACTTGCGCAAGAAACTAAATACGTCGCC|ATGCATCGGCGGTTAAGCGTCTTAGGCTGC
AATACGTCGCCCGACGTTCAGCGCAAGAAA|GTATCCGTGGTGAGCAAGAAACTAAATACG
GTTACTTATTGCCGCACTCTCTCAAAATCG|GCAATGCTAGTTGTTGCCAATCACTATTAC
GCCCGACGTTCAAATACTAGACCGAAATAA|CCGACGTTCCCAACAAGTTATAATTCGATT
AAATCGTGGTATAAGCTCCGATATAGGCGT|TATTACATGGTCTCATTATTCAAGGAGGCC
GGAGGCCAGCAGAACCTTGTTGCCTGAGCC|ACGTTTTAAAGACCGGTACACACCGTGACT
ATGCAAGCTACCTGTTATCAGTAGTCCGCC|TATACCGTGACGCAAGAAACTAAATACGTC
CTCATTATTCAAGGAGGCCAGCAGAACCTT|CAGAATCCTGTTACGTTTTAAAGACCGGTA
AAATACGTCGCCCGACGTTCGGGATTGCAA|GAGATCGTCGCGTATAAGGAACCAGCAAGA
GCCGCAAGAAACTAAATACGTCGCCCGACG|TATTGCCGCACTCTCTCAAAATCGTGGTAT
CCCGACGTTCATGAAACTGTCCAGGGAGAT|GTGGTATAAGCTCCGATATAGGCGTTTGGC
AGTCAAAAACATGCATCGGCGGTTAAGCGT|CGGCACCGCGAGGGTTAGCAAGAAACTAAA
TCCAAGTCAAAAACATGCATCGGCGGTTAA|CGTGCGGCACCGCGAGGGTTAGCAAGAAAC
CGCGAGGGTTAGCAAGAAACTAAATACGTC|GCCCGTTGATGCCGGCCTGGTCGGTGGCAA
CCAATCACTATTACATGGTCTCATTATTCA|TTCCGAAGGCCCGGGCTGACAGAATCCTGT
AACTAAATACGTCGCCCGACGTTCACCTGC|CGCAAGTAAGCGTGTGTCACAAGTTAGACA
