TAGGTGGCAGGTCGGTGTA -> AGGTGGCAGGTCGGTGTAC
AAGATATCGAGTCCCGTCC -> AGATATCGAGTCCCGTCCC
ATGGAGATACTGATCACAG -> TGGAGATACTGATCACAGA
GGCGTGGCGTTCAGCATCG -> GCGTGGCGTTCAGCATCGG
AGAGATATCAAGGGGCGCG -> GAGATATCAAGGGGCGCGC
TAAGCACGGCGATGCGCTA -> AAGCACGGCGATGCGCTAC
GCGTAGTTACCCAGAATCT -> CGTAGTTACCCAGAATCTG
CGCCTGAATACATGTCGGC -> GCCTGAATACATGTCGGCC
GAGCTGGCCTATCGAATTC -> AGCTGGCCTATCGAATTCT
TAATCCCCACTTCGAACTG -> AATCCCCACTTCGAACTGC
CCTTGCAATTAGGATGATA -> CTTGCAATTAGGATGATAA
GACCGGTAAAAGCTGGTTC -> ACCGGTAAAAGCTGGTTCA
ATACCCCTGAAGCTCAAGA -> TACCCCTGAAGCTCAAGAA
CACCTCCCACCTCTACTCA -> ACCTCCCACCTCTACTCAT
GTGTGTGTGATTGAGCACG -> TGTGTGTGATTGAGCACGC
ACCCGCCTAGCATATTAGA -> CCCGCCTAGCATATTAGAC
CAGACTCAGAATGTGACGA -> AGACTCAGAATGTGACGAC
CTGATCTATATTATTCCTC -> TGATCTATATTATTCCTCG
TCACGCCACTACCTTTTTA -> CACGCCACTACCTTTTTAT
TCGCCGGGGCGCTCCAGAG -> CGCCGGGGCGCTCCAGAGT
GCTGGCCTATCGAATTCTA -> CTGGCCTATCGAATTCTAA
AGTGTTCTCCGTGATCAAA -> GTGTTCTCCGTGATCAAAT
ATTCCACTGTTAGTTTCCC -> TTCCACTGTTAGTTTCCCG
GAATCGAGTAGCGGGACGC -> AATCGAGTAGCGGGACGCA
GCAATGCCTGTTTCGCGAT -> CAATGCCTGTTTCGCGATT
TGGAGAGATATCAAGGGGC -> GGAGAGATATCAAGGGGCG
TTATCAGTGTTATAGGTGG -> TATCAGTGTTATAGGTGGC
GTCATTAGATCGTAGTCGC -> TCATTAGATCGTAGTCGCA
GGTGGCAGGTCGGTGTACT -> GTGGCAGGTCGGTGTACTG
CCTCCGCGTGTAGTCATTA -> CTCCGCGTGTAGTCATTAG
ATTGCAAATCCCTGACTCA -> TTGCAAATCCCTGACTCAC
GACAGGGGCGCAGGGTGGA -> ACAGGGGCGCAGGGTGGAA
CCGGTACCACCCCAAGCCA -> CGGTACCACCCCAAGCCAC
CGGGTCTAGGGACAAGTAC -> GGGTCTAGGGACAAGTACC
GACTTCTCCTACGCATCAT -> ACTTCTCCTACGCATCATA
AGCTCAAGAACACAAGTGA -> GCTCAAGAACACAAGTGAG
TTGGGGGGTCCTCTCACCT -> TGGGGGGTCCTCTCACCTG
CATACCTTTGGAGAGATAT -> ATACCTTTGGAGAGATATC
CGGAATTTGACAGTCCCGG -> GGAATTTGACAGTCCCGGC
GACCCATCGGGCTGTCACC -> ACCCATCGGGCTGTCACCA
GCAATCCGGAGAGCCATTC -> CAATCCGGAGAGCCATTCC
CGGTACGTGTGAGTTGGAC -> GGTACGTGTGAGTTGGACA
TCTTTGTTAGTCCTATGAG -> CTTTGTTAGTCCTATGAGC
CATTAACCGGTAACCAATC -> ATTAACCGGTAACCAATCT
TACTCCGGTGAGGAACATC -> ACTCCGGTGAGGAACATCA
ATTCACGCAGCAAATACTC -> TTCACGCAGCAAATACTCC
TTGGCGCTGTAGAGGCAGT -> TGGCGCTGTAGAGGCAGTC
GTAGGCAGGTAAGGCCTGC -> TAGGCAGGTAAGGCCTGCG
GAATGAGTTCCACCAACGC -> AATGAGTTCCACCAACGCA
GATGATAAGACAATGCTAG -> ATGATAAGACAATGCTAGG
CTAGGGCCTGTGCCCCCGC -> TAGGGCCTGTGCCCCCGCC
TCTACGGTCGTACCTCCGC -> CTACGGTCGTACCTCCGCG
AGGGGGAAGGCAGACTCAG -> GGGGGAAGGCAGACTCAGA
GCTCCCTTCCAATCCGAGT -> CTCCCTTCCAATCCGAGTG
CATCATATAGACTTCTGAA -> ATCATATAGACTTCTGAAT
CCCTTCCAATCCGAGTGTT -> CCTTCCAATCCGAGTGTTT
TCCGCGTGTAGTCATTAGA -> CCGCGTGTAGTCATTAGAT
ATGAACGTCGCATTCATAA -> TGAACGTCGCATTCATAAG
TCTCCTACGCATCATATAG -> CTCCTACGCATCATATAGA
GTTCTACGAAGAAGTGTTC -> TTCTACGAAGAAGTGTTCT
CCAAGCCACTCCGTTTGTT -> CAAGCCACTCCGTTTGTTG
AATCGCTTGGGGGGTCCTC -> ATCGCTTGGGGGGTCCTCT
GAAGGCAGACTCAGAATGT -> AAGGCAGACTCAGAATGTG
GAGTTCCACCAACGCATCA -> AGTTCCACCAACGCATCAT
CCCGAACCTAGGGCCTGTG -> CCGAACCTAGGGCCTGTGC
TTCCTTACATTGTTAGAGA -> TCCTTACATTGTTAGAGAG
TAGCACCTCCCACCTCTAC -> AGCACCTCCCACCTCTACT
GTCCCGTCCCGGCGAGGCA -> TCCCGTCCCGGCGAGGCAT
ATGGGATACCCGAACCTAG -> TGGGATACCCGAACCTAGG
CGACTGATCGAGCGCCATC -> GACTGATCGAGCGCCATCA
GAGATATCAAGGGGCGCGC -> AGATATCAAGGGGCGCGCG
CGACCGGTAAAAGCTGGTT -> GACCGGTAAAAGCTGGTTC
TAGGGCCTGTGCCCCCGCC -> AGGGCCTGTGCCCCCGCCT
GCCATCAGTAACAAGGTTA -> CCATCAGTAACAAGGTTAT
TCATCTAAGCTTGTGTCCC -> CATCTAAGCTTGTGTCCCC
TTGCCAGTAAGAGCGACAG -> TGCCAGTAAGAGCGACAGG
ATGGAGAAATTCGATCTTA -> TGGAGAAATTCGATCTTAA
GCCATTGCAAATCCCTGAC -> CCATTGCAAATCCCTGACT
ACAAGGTTATGACGTAGCA -> CAAGGTTATGACGTAGCAC
CAAATGAACGTCGCATTCA -> AAATGAACGTCGCATTCAT
GTCGGTGTACTGTCACGCC -> TCGGTGTACTGTCACGCCA
GTTAGAGAGTTATGATGCT -> TTAGAGAGTTATGATGCTA
ATTGTCAGGCTACCGAAGT -> TTGTCAGGCTACCGAAGTC
TCATTGACAATTTGCTAGC -> CATTGACAATTTGCTAGCT
GTCTTTGTTAGTCCTATGA -> TCTTTGTTAGTCCTATGAG
CAAATACTCCGGTGAGGAA -> AAATACTCCGGTGAGGAAC
AAATGAACGTCGCATTCAT -> AATGAACGTCGCATTCATA
TCACGCAGCAAATACTCCG -> CACGCAGCAAATACTCCGG
AGCATCGGTTACGACGTAG -> GCATCGGTTACGACGTAGA
AGAGTAAACGCATCATATA -> GAGTAAACGCATCATATAG
TTGCGGAGCCATTGCAAAT -> TGCGGAGCCATTGCAAATC
CTTCTCCTACGCATCATAT -> TTCTCCTACGCATCATATA
CCCACCTCTACTCATGAAC -> CCACCTCTACTCATGAACA
TGATGCTAAATGGTCGGGT -> GATGCTAAATGGTCGGGTC
CCATCAGTAACAAGGTTAT -> CATCAGTAACAAGGTTATG
CGAAAAGGACCCTATCGCT -> GAAAAGGACCCTATCGCTT
GGGTCTAGGGACAAGTACC -> GGTCTAGGGACAAGTACCC
CCTCGCCGGGGCGCTCCAG -> CTCGCCGGGGCGCTCCAGA
CTGAATTGTCAGAGTAAAC -> TGAATTGTCAGAGTAAACG
GACCTTCTTTTACGGCTTC -> ACCTTCTTTTACGGCTTCA
ATTTCACTACACGTCGGTG -> TTTCACTACACGTCGGTGA
ATTAACCAGGAAAGATCTG -> TTAACCAGGAAAGATCTGT
TCATACCCCTGAAGCTCAA -> CATACCCCTGAAGCTCAAG
CCTAGGGCCTGTGCCCCCG -> CTAGGGCCTGTGCCCCCGC
CCGGCGTGGCGTTCAGCAT -> CGGCGTGGCGTTCAGCATC
TTCTACGAAGAAGTGTTCT -> TCTACGAAGAAGTGTTCTC
CACGCCTGAATACATGTCG -> ACGCCTGAATACATGTCGG
TCTAGTCTCGGTGGGTATT -> CTAGTCTCGGTGGGTATTC
GTTAGTCCTATGAGCGAAA -> TTAGTCCTATGAGCGAAAA
CGAGCGGATGGACTGTCCG -> GAGCGGATGGACTGTCCGT
GCAAGAACGAGCGGATGGA -> CAAGAACGAGCGGATGGAC
CTATATTATTCCTCGCCGG -> TATATTATTCCTCGCCGGG
CGCGTGTAGTCATTAGATC -> GCGTGTAGTCATTAGATCG
AAAATAGCATTGGTGATGG -> AAATAGCATTGGTGATGGA
TGAGCTGGCCTATCGAATT -> GAGCTGGCCTATCGAATTC
CCGGATTAACCAGGAAAGA -> CGGATTAACCAGGAAAGAT
AGGCAGACTCAGAATGTGA -> GGCAGACTCAGAATGTGAC
TAGGTCTTAGCAATTACCT -> AGGTCTTAGCAATTACCTG
ATTAACCGGTAACCAATCT -> TTAACCGGTAACCAATCTA
GAAAGATCTGTCAGTTAGT -> AAAGATCTGTCAGTTAGTC
TATCATTAACCGGTAACCA -> ATCATTAACCGGTAACCAA
CTTAGCACCTCCCACCTCT -> TTAGCACCTCCCACCTCTA
GCGCGAAGGATAGCTAGTT -> CGCGAAGGATAGCTAGTTG
ACCAGGAAAGATCTGTCAG -> CCAGGAAAGATCTGTCAGT
GTCAACTGCGGGGAAATCG -> TCAACTGCGGGGAAATCGC
AACTTACGCATACCTTTGG -> ACTTACGCATACCTTTGGA
TGGCCTCTTTGATATCGCT -> GGCCTCTTTGATATCGCTT
ATCTGATGTGTGTGTGATT -> TCTGATGTGTGTGTGATTG
TTCACCTTAGGTCTTAGCA -> TCACCTTAGGTCTTAGCAA
CTCCGGTGAGGAACATCAT -> TCCGGTGAGGAACATCATT
GGTCGTACCTCCGCGTGTA -> GTCGTACCTCCGCGTGTAG
TTAATTATCAGTGTTATAG -> TAATTATCAGTGTTATAGG
GGTCGGGTCTAGGGACAAG -> GTCGGGTCTAGGGACAAGT
AGTTCTACGAAGAAGTGTT -> GTTCTACGAAGAAGTGTTC
AAGAAAAAGAGTACCACGG -> AGAAAAAGAGTACCACGGC
GTTACGGAGCGCTTACTCT -> TTACGGAGCGCTTACTCTG
AGGATGATAAGACAATGCT -> GGATGATAAGACAATGCTA
CCAGTAAGAGCGACAGGAG -> CAGTAAGAGCGACAGGAGG
TAAGCGAAAACCCGGATTA -> AAGCGAAAACCCGGATTAA
GTTTCGCGATTCACGCAGC -> TTTCGCGATTCACGCAGCA
GAGAGCCATTCCTTACATT -> AGAGCCATTCCTTACATTG
CCAGTTGCCGATGATCCGT -> CAGTTGCCGATGATCCGTA
TCGAGTCCCGTCCCGGCGA -> CGAGTCCCGTCCCGGCGAG
CCCTATCGCTTGCGCCAGT -> CCTATCGCTTGCGCCAGTT
GACTTCTGAATCTGATGTG -> ACTTCTGAATCTGATGTGT
GGCCTAACGCTATTTCCAT -> GCCTAACGCTATTTCCATG
CCGGTAAAAGCTGGTTCAC -> CGGTAAAAGCTGGTTCACT
TCACTACACGTCGGTGATG -> CACTACACGTCGGTGATGA
AGACTTCTCCTACGCATCA -> GACTTCTCCTACGCATCAT
CACAATGGGATACCCGAAC -> ACAATGGGATACCCGAACC
CAGTTGCCGATGATCCGTA -> AGTTGCCGATGATCCGTAG
ACACCGCTTCAAGATATCG -> CACCGCTTCAAGATATCGA
ATGAACACCGCTTCAAGAT -> TGAACACCGCTTCAAGATA
ACGACTGATCGAGCGCCAT -> CGACTGATCGAGCGCCATC
GTGGCAGGTCGGTGTACTG -> TGGCAGGTCGGTGTACTGT
GTAGTCGCAAGAACGAGCG -> TAGTCGCAAGAACGAGCGG
GATACTGATCACAGAGTTG -> ATACTGATCACAGAGTTGG
TCCCTGACTCACGCCTGAA -> CCCTGACTCACGCCTGAAT
TCTGCTTTGCGGAGCCATT -> CTGCTTTGCGGAGCCATTG
TCTGATGTGTGTGTGATTG -> CTGATGTGTGTGTGATTGA
ACCTGACTCACGCCTGAAT -> CCTGACTCACGCCTGAATA
AACAAGGTTATGACGTAGC -> ACAAGGTTATGACGTAGCA
ACCACGATTAGCCAGTAGG -> CCACGATTAGCCAGTAGGC
TTCTGAATCTGATGTGTGT -> TCTGAATCTGATGTGTGTG
AGGGCCTGTGCCCCCGCCT -> GGGCCTGTGCCCCCGCCTG
GTGTTTCACCTTAGGTCTT -> TGTTTCACCTTAGGTCTTA
TGATCTATATTATTCCTCG -> GATCTATATTATTCCTCGC
GCCCGTTGTTTGCCAGTAA -> CCCGTTGTTTGCCAGTAAG
TGGAGATACTGATCACAGA -> GGAGATACTGATCACAGAG
ACTGACCTTCTTTTACGGC -> CTGACCTTCTTTTACGGCT
TAGGATGTAAGCTTGTATC -> AGGATGTAAGCTTGTATCC
TTTGTTAGTCCTATGAGCG -> TTGTTAGTCCTATGAGCGA
GGTATGTGTTACATAATCC -> GTATGTGTTACATAATCCC
CCCCACTTCGAACTGCAAC -> CCCACTTCGAACTGCAACC
GTTGCATAACTCATCGAAG -> TTGCATAACTCATCGAAGA
CTCATCGAAGACTAGGTTG -> TCATCGAAGACTAGGTTGT
GCTTAGCACCTCCCACCTC -> CTTAGCACCTCCCACCTCT
GCGCTCCAGAGTCCGGTAC -> CGCTCCAGAGTCCGGTACC
TGGACAGGGGCGCAGGGTG -> GGACAGGGGCGCAGGGTGG
AGGGACAAGTACCCCATTT -> GGGACAAGTACCCCATTTT
AGTCTTTGTTAGTCCTATG -> GTCTTTGTTAGTCCTATGA
AATTCTAACTGAAATCCCA -> ATTCTAACTGAAATCCCAA
AGACTAGGTTGTTGTAAAG -> GACTAGGTTGTTGTAAAGG
ACCTCCCACCTCTACTCAT -> CCTCCCACCTCTACTCATG
ACCTTTGGAGAGATATCAA -> CCTTTGGAGAGATATCAAG
CCGAAGTCTTTGTTAGTCC -> CGAAGTCTTTGTTAGTCCT
GATTCTCTGAGCACCGTTG -> ATTCTCTGAGCACCGTTGA
GGGCTGTCACCAACGAGGG -> GGCTGTCACCAACGAGGGA
ATCCAAAAGTTCTACGAAG -> TCCAAAAGTTCTACGAAGA
GCCTGACTCACGTCCTGAC -> CCTGACTCACGTCCTGACT
AAACACGCGTAGTTACCCA -> AACACGCGTAGTTACCCAG
TGCGGGGAAATCGCTTGGG -> GCGGGGAAATCGCTTGGGG
AGCACCTCCCACCTCTACT -> GCACCTCCCACCTCTACTC
GATCTATATTATTCCTCGC -> ATCTATATTATTCCTCGCC
TCAGTTAGTCAGTCCAGCA -> CAGTTAGTCAGTCCAGCAA
CGATTAGCCAGTAGGCAGG -> GATTAGCCAGTAGGCAGGT
GGTTTCCGTCCTCTCAAAC -> GTTTCCGTCCTCTCAAACC
AGATTCATGCTCCCTTCCA -> GATTCATGCTCCCTTCCAA
GATGGACTGTCCGTCTCTA -> ATGGACTGTCCGTCTCTAG
TCGTGGTACCAACAACAAA -> CGTGGTACCAACAACAAAG
CGTGCCGAACATAGTTCGG -> GTGCCGAACATAGTTCGGC
ATAGGTGGCAGGTCGGTGT -> TAGGTGGCAGGTCGGTGTA
AACAACAAAGCGCCGAGTC -> ACAACAAAGCGCCGAGTCT
CGAAAACCCGGATTAACCA -> GAAAACCCGGATTAACCAG
AATCTGATGTGTGTGTGAT -> ATCTGATGTGTGTGTGATT
CCCAACGGAATTTGACAGT -> CCAACGGAATTTGACAGTC
ATACCTTTGGAGAGATATC -> TACCTTTGGAGAGATATCA
CCCGCCGTAAGCGAAAACC -> CCGCCGTAAGCGAAAACCC
GCAAATACTCCGGTGAGGA -> CAAATACTCCGGTGAGGAA
CCAGAGTCCGGTACCACCC -> CAGAGTCCGGTACCACCCC
GGACCGCCTAGAGTCGTGC -> GACCGCCTAGAGTCGTGCC
AAAGGTCTAAACTGAGGCC -> AAGGTCTAAACTGAGGCCT
TCATCTAGGCCAATTGCCC -> CATCTAGGCCAATTGCCCG
CCGTTGATGCAATCTCGTC -> CGTTGATGCAATCTCGTCA
TGCCCGTTGTTTGCCAGTA -> GCCCGTTGTTTGCCAGTAA
AGCGGTACGTGTGAGTTGG -> GCGGTACGTGTGAGTTGGA
TCATATAGACTTCTACGGT -> CATATAGACTTCTACGGTC
GAGTCCCGTCCCGGCGAGG -> AGTCCCGTCCCGGCGAGGC
TCCCCACTTCGAACTGCAA -> CCCCACTTCGAACTGCAAC
CCTGCCAGGGGGAAGGCAG -> CTGCCAGGGGGAAGGCAGA
CCAATCTAGTCTCGGTGGG -> CAATCTAGTCTCGGTGGGT
ATCGCTTATATACGGTTAT -> TCGCTTATATACGGTTATC
TTAGACTTGGCGCCTAGGC -> TAGACTTGGCGCCTAGGCA
GTGCCCCCGCCTGCGGTGA -> TGCCCCCGCCTGCGGTGAG
ATCCGGAGAGCCATTCCTT -> TCCGGAGAGCCATTCCTTA
TCATGAGTGAGCTGGCCTA -> CATGAGTGAGCTGGCCTAT
CACGTCGGTGATGATTATG -> ACGTCGGTGATGATTATGA
TTCCGTCCTCTCAAACCGG -> TCCGTCCTCTCAAACCGGG
GATACCCGAACCTAGGGCC -> ATACCCGAACCTAGGGCCT
TCATGCTGCAATCCGGAGA -> CATGCTGCAATCCGGAGAG
AATGGTCGGGTCTAGGGAC -> ATGGTCGGGTCTAGGGACA
AATGGGATACCCGAACCTA -> ATGGGATACCCGAACCTAG
TGATGATTATGATTTCTGG -> GATGATTATGATTTCTGGA
CTCACGCCTGAATACATGT -> TCACGCCTGAATACATGTC
TTGTCAGAGTAAACGCATC -> TGTCAGAGTAAACGCATCA
CTCCCTTCCAATCCGAGTG -> TCCCTTCCAATCCGAGTGT
GAGTAGCGGGACGCATCAT -> AGTAGCGGGACGCATCATA
GCGCCATCAGTAACAAGGT -> CGCCATCAGTAACAAGGTT
GACAATGCTAGGCGCTGGA -> ACAATGCTAGGCGCTGGAG
TTATGACGTAGCACAATGG -> TATGACGTAGCACAATGGG
CATGCTGCAATCCGGAGAG -> ATGCTGCAATCCGGAGAGC
GGTAAAAGCTGGTTCACTC -> GTAAAAGCTGGTTCACTCA
TGTCAGTTAGTCAGTCCAG -> GTCAGTTAGTCAGTCCAGC
GATAAGCACGGCGATGCGC -> ATAAGCACGGCGATGCGCT
CTCATGAGTGAGCTGGCCT -> TCATGAGTGAGCTGGCCTA
TTTGACATATGTCGCCACA -> TTGACATATGTCGCCACAT
ACAAAGCGCCGAGTCTTCC -> CAAAGCGCCGAGTCTTCCT
GGTTCACTCATGAGTGAGC -> GTTCACTCATGAGTGAGCT
TATTATTCCTCGCCGGGGC -> ATTATTCCTCGCCGGGGCG
CTACTCATGAACACCGCTT -> TACTCATGAACACCGCTTC
TTTCCATGGAGATACTGAT -> TTCCATGGAGATACTGATC
CAGGCTACCGAAGTCTTTG -> AGGCTACCGAAGTCTTTGT
TGATTGAGCACGCGACCGG -> GATTGAGCACGCGACCGGT
TCTCAAACCGGGGTCTATA -> CTCAAACCGGGGTCTATAC
GGACAAGTACCCCATTTTG -> GACAAGTACCCCATTTTGA
GCATTCTGTAACCTGACTC -> CATTCTGTAACCTGACTCA
GGCCTGCGCGAGTCGTCGA -> GCCTGCGCGAGTCGTCGAA
TGATGTGTGTGTGATTGAG -> GATGTGTGTGTGATTGAGC
TGTATCCGCCCGACAGGCC -> GTATCCGCCCGACAGGCCC
CTAAGCTTGTGTCCCCGCC -> TAAGCTTGTGTCCCCGCCC
GAAGCGGTACGTGTGAGTT -> AAGCGGTACGTGTGAGTTG
CTACGAAGAAGTGTTCTCC -> TACGAAGAAGTGTTCTCCG
AGCGAAAAGGACCCTATCG -> GCGAAAAGGACCCTATCGC
TCGTCAGATTCATCTAGGC -> CGTCAGATTCATCTAGGCC
ATCATATAGACTTCTACGG -> TCATATAGACTTCTACGGT
CGGATGGACTGTCCGTCTC -> GGATGGACTGTCCGTCTCT
CGCTATTTCCATGGAGATA -> GCTATTTCCATGGAGATAC
CGTGGTACCAACAACAAAG -> GTGGTACCAACAACAAAGC
GATGATTATGATTTCTGGA -> ATGATTATGATTTCTGGAC
CCACCAACGCATCATATAG -> CACCAACGCATCATATAGA
TGTCAGGCTACCGAAGTCT -> GTCAGGCTACCGAAGTCTT
AACCTAGGGCCTGTGCCCC -> ACCTAGGGCCTGTGCCCCC
ACGGAATTTGACAGTCCCG -> CGGAATTTGACAGTCCCGG
TGGTTTCCGTCCTCTCAAA -> GGTTTCCGTCCTCTCAAAC
CTTTTTATAGGATGTAAGC -> TTTTTATAGGATGTAAGCT
AGATATCGAGTCCCGTCCC -> GATATCGAGTCCCGTCCCG
GGCCTATCGAATTCTAACT -> GCCTATCGAATTCTAACTG
CACGCCTGAATCGAGTAGC -> ACGCCTGAATCGAGTAGCG
GCTTATATACGGTTATCAT -> CTTATATACGGTTATCATT
AGTCATTAGATCGTAGTCG -> GTCATTAGATCGTAGTCGC
ACGCATTAACCACGATTAG -> CGCATTAACCACGATTAGC
CCAACGGAATTTGACAGTC -> CAACGGAATTTGACAGTCC
TCGCAAGAACGAGCGGATG -> CGCAAGAACGAGCGGATGG
CAATGCCTGTTTCGCGATT -> AATGCCTGTTTCGCGATTC
CTTAATTATCAGTGTTATA -> TTAATTATCAGTGTTATAG
CTGCGCGAGTCGTCGAACT -> TGCGCGAGTCGTCGAACTG
TAACCGGTAACCAATCTAG -> AACCGGTAACCAATCTAGT
ATATTAGACTTGGCGCCTA -> TATTAGACTTGGCGCCTAG
GAATTTCACTACACGTCGG -> AATTTCACTACACGTCGGT
ATCGGTTACGACGTAGAGA -> TCGGTTACGACGTAGAGAT
GCTATTTCCATGGAGATAC -> CTATTTCCATGGAGATACT
CCTGACTCACGCCTGAATC -> CTGACTCACGCCTGAATCG
CACGCCTGAATTGTCAGAG -> ACGCCTGAATTGTCAGAGT
ACCGCTTCAAGATATCGAG -> CCGCTTCAAGATATCGAGT
GGTCTATACAAACACGCGT -> GTCTATACAAACACGCGTA
CCGTAGTGCACTCGTGGTA -> CGTAGTGCACTCGTGGTAC
AGTACCACGGCCTAACGCT -> GTACCACGGCCTAACGCTA
CCTGAATGAGTTCCACCAA -> CTGAATGAGTTCCACCAAC
CGAAGGATAGCTAGTTGTT -> GAAGGATAGCTAGTTGTTA
CGGGCTGTCACCAACGAGG -> GGGCTGTCACCAACGAGGG
GCGGGACGCATCATATAGA -> CGGGACGCATCATATAGAC
ACGCCTGAATCGAGTAGCG -> CGCCTGAATCGAGTAGCGG
AACTGCAACCCGCCTAGCA -> ACTGCAACCCGCCTAGCAT
ACCAACGAGGGATTGTCAG -> CCAACGAGGGATTGTCAGG
AACGGAATTTGACAGTCCC -> ACGGAATTTGACAGTCCCG
TACGAAGAAGTGTTCTCCG -> ACGAAGAAGTGTTCTCCGT
TAATTATCAGTGTTATAGG -> AATTATCAGTGTTATAGGT
TAGACTTCTCCTACGCATC -> AGACTTCTCCTACGCATCA
CCGAGTGTTTCACCTTAGG -> CGAGTGTTTCACCTTAGGT
CACCTGCCAGGGGGAAGGC -> ACCTGCCAGGGGGAAGGCA
GAGATCCCAAATGAACGTC -> AGATCCCAAATGAACGTCG
AGAACGAGCGGATGGACTG -> GAACGAGCGGATGGACTGT
TGTCGCCACATTGGCGCTG -> GTCGCCACATTGGCGCTGT
TTGGCGCCTAGGCAATGCC -> TGGCGCCTAGGCAATGCCT
TACCGAAGTCTTTGTTAGT -> ACCGAAGTCTTTGTTAGTC
ACGGCTTCATACCCCTGAA -> CGGCTTCATACCCCTGAAG
GTTGCCGATGATCCGTAGT -> TTGCCGATGATCCGTAGTG
ACTCTGTCAACTGCGGGGA -> CTCTGTCAACTGCGGGGAA
AGATTCATCTAGGCCAATT -> GATTCATCTAGGCCAATTG
ATTGTCAGAGTAAACGCAT -> TTGTCAGAGTAAACGCATC
AAACTGAGGCCTCACTAAC -> AACTGAGGCCTCACTAACT
CCGGTAACCAATCTAGTCT -> CGGTAACCAATCTAGTCTC
GGAGAGATATCAAGGGGCG -> GAGAGATATCAAGGGGCGC
CGTCGAACTGGTTTCCGTC -> GTCGAACTGGTTTCCGTCC
TGATCGAGCGCCATCAGTA -> GATCGAGCGCCATCAGTAA
GCATCGGTTACGACGTAGA -> CATCGGTTACGACGTAGAG
CTGTCAACTGCGGGGAAAT -> TGTCAACTGCGGGGAAATC
CCTGTTTCGCGATTCACGC -> CTGTTTCGCGATTCACGCA
TTGCTAGCTTAGCACCTCC -> TGCTAGCTTAGCACCTCCC
CGCCCGACAGGCCCTTGCA -> GCCCGACAGGCCCTTGCAA
CGAATTCTAACTGAAATCC -> GAATTCTAACTGAAATCCC
ATATCGCTTATATACGGTT -> TATCGCTTATATACGGTTA
ACGTCCTGACTCACGCCTG -> CGTCCTGACTCACGCCTGA
ATCGAATTCTAACTGAAAT -> TCGAATTCTAACTGAAATC
AGACTTCTCCTGAATGAGT -> GACTTCTCCTGAATGAGTT
AACGCATCATATAGACTTC -> ACGCATCATATAGACTTCT,ACGCATCATATAGACTTCT
TGAACACCGCTTCAAGATA -> GAACACCGCTTCAAGATAT
CTCAAACCGGGGTCTATAC -> TCAAACCGGGGTCTATACA
AATCTAGTCTCGGTGGGTA -> ATCTAGTCTCGGTGGGTAT
TCACGCCTGAATACATGTC -> CACGCCTGAATACATGTCG
AGTGAGCTGGCCTATCGAA -> GTGAGCTGGCCTATCGAAT
CAGTAAGAGCGACAGGAGG -> AGTAAGAGCGACAGGAGGA
TGTGTCCCCGCCCTGGTAT -> GTGTCCCCGCCCTGGTATA
AGTCCCGGCGTGGCGTTCA -> GTCCCGGCGTGGCGTTCAG
CTGGTTCACTCATGAGTGA -> TGGTTCACTCATGAGTGAG
ATTATCAGTGTTATAGGTG -> TTATCAGTGTTATAGGTGG
TCGGCCCTGACTACACGAA -> CGGCCCTGACTACACGAAT
TTCGCGATTCACGCAGCAA -> TCGCGATTCACGCAGCAAA
AGACTCAGAATGTGACGAC -> GACTCAGAATGTGACGACT
CTCTTTGATATCGCTTATA -> TCTTTGATATCGCTTATAT
AGGAAGCGGTACGTGTGAG -> GGAAGCGGTACGTGTGAGT
TCCGGTGAGGAACATCATT -> CCGGTGAGGAACATCATTG
CAGTAGGCAGGTAAGGCCT -> AGTAGGCAGGTAAGGCCTG
GCCCCCGCCTGCGGTGAGA -> CCCCCGCCTGCGGTGAGAC
TTCTACGGTCGTACCTCCG -> TCTACGGTCGTACCTCCGC
TAGTTCGGCCCTGACTACA -> AGTTCGGCCCTGACTACAC
CGGGGCGCTCCAGAGTCCG -> GGGGCGCTCCAGAGTCCGG
ATACTGATCACAGAGTTGG -> TACTGATCACAGAGTTGGT
ACCGGGGTCTATACAAACA -> CCGGGGTCTATACAAACAC
TGAGCGAAAAGGACCCTAT -> GAGCGAAAAGGACCCTATC
ACCCATCGGGCTGTCACCA -> CCCATCGGGCTGTCACCAA
GAGACCCATCGGGCTGTCA -> AGACCCATCGGGCTGTCAC
ACCTGTCTGTTCTCATGCT -> CCTGTCTGTTCTCATGCTG
CGTTTGTTGCATAACTCAT -> GTTTGTTGCATAACTCATC
TTAACCGGTAACCAATCTA -> TAACCGGTAACCAATCTAG
GGATGATAAGACAATGCTA -> GATGATAAGACAATGCTAG
AACGAATCCAAAAGTTCTA -> ACGAATCCAAAAGTTCTAC
TCCCCGCCCTGGTATACAC -> CCCCGCCCTGGTATACACT
GCTAGGCGCTGGAGTCTGC -> CTAGGCGCTGGAGTCTGCT
GAATCCAAAAGTTCTACGA -> AATCCAAAAGTTCTACGAA
TTTGCTAGCTTAGCACCTC -> TTGCTAGCTTAGCACCTCC
TGTAACCTGACTCACGCCT -> GTAACCTGACTCACGCCTG
TTACGCATACCTTTGGAGA -> TACGCATACCTTTGGAGAG
ACAAGTGAGGAAGCGGTAC -> CAAGTGAGGAAGCGGTACG
AGGGTGGAATTTCACTACA -> GGGTGGAATTTCACTACAC
CGGATTAACCAGGAAAGAT -> GGATTAACCAGGAAAGATC
GCCTAGAGTCGTGCCGAAC -> CCTAGAGTCGTGCCGAACA
GGACGCATCATATAGACTT -> GACGCATCATATAGACTTC
GTCAGATTCATCTAGGCCA -> TCAGATTCATCTAGGCCAA
CCCTTGCAATTAGGATGAT -> CCTTGCAATTAGGATGATA
TCTTAGCAATTACCTGATC -> CTTAGCAATTACCTGATCT
CCTTAGGTCTTAGCAATTA -> CTTAGGTCTTAGCAATTAC
TCTCTGAGCACCGTTGATG -> CTCTGAGCACCGTTGATGC
ATATCAAGGGGCGCGCGAA -> TATCAAGGGGCGCGCGAAG
ATCGTAGTCGCAAGAACGA -> TCGTAGTCGCAAGAACGAG
ACCCCTGAAGCTCAAGAAC -> CCCCTGAAGCTCAAGAACA
CCTGACTCACGCCTGAATT -> CTGACTCACGCCTGAATTG
CACTACACGTCGGTGATGA -> ACTACACGTCGGTGATGAT
GGTAACCAATCTAGTCTCG -> GTAACCAATCTAGTCTCGG
GACTTCTCCTGAATGAGTT -> ACTTCTCCTGAATGAGTTC
TTTGATATCGCTTATATAC -> TTGATATCGCTTATATACG
CGTTGTTTGCCAGTAAGAG -> GTTGTTTGCCAGTAAGAGC
CGCGAAGGATAGCTAGTTG -> GCGAAGGATAGCTAGTTGT
ATCTAGGCCAATTGCCCGT -> TCTAGGCCAATTGCCCGTT
TACGTGTGAGTTGGACAGG -> ACGTGTGAGTTGGACAGGG
AAGCCACTCCGTTTGTTGC -> AGCCACTCCGTTTGTTGCA
CAACGCATCATATAGACTT -> AACGCATCATATAGACTTC
ATCGAGCGCCATCAGTAAC -> TCGAGCGCCATCAGTAACA
TTGATATCGCTTATATACG -> TGATATCGCTTATATACGG
TTCTCATGCTGCAATCCGG -> TCTCATGCTGCAATCCGGA
TCCCGTCCCGGCGAGGCAT -> CCCGTCCCGGCGAGGCATT
TGCGGTGAGACCCATCGGG -> GCGGTGAGACCCATCGGGC
GAGCACCGTTGATGCAATC -> AGCACCGTTGATGCAATCT
CGTCCCGGCGAGGCATTCT -> GTCCCGGCGAGGCATTCTG
ATGCTCCCTTCCAATCCGA -> TGCTCCCTTCCAATCCGAG
TGAATTGTCAGAGTAAACG -> GAATTGTCAGAGTAAACGC
TAGACTTGGCGCCTAGGCA -> AGACTTGGCGCCTAGGCAA
GGACTGTCCGTCTCTAGAT -> GACTGTCCGTCTCTAGATC
GTTGATGCAATCTCGTCAG -> TTGATGCAATCTCGTCAGA
AACGAGGGATTGTCAGGCT -> ACGAGGGATTGTCAGGCTA
CTGATCGAGCGCCATCAGT -> TGATCGAGCGCCATCAGTA
AAAAAGAGTACCACGGCCT -> AAAAGAGTACCACGGCCTA
AGGGGCGCGCGAAGGATAG -> GGGGCGCGCGAAGGATAGC
GGTTATGACGTAGCACAAT -> GTTATGACGTAGCACAATG
CAGGGGGAAGGCAGACTCA -> AGGGGGAAGGCAGACTCAG
ACTTCTGAATCTGATGTGT -> CTTCTGAATCTGATGTGTG
CCAGAATCTGGCCTCTTTG -> CAGAATCTGGCCTCTTTGA
GTCAGGCTACCGAAGTCTT -> TCAGGCTACCGAAGTCTTT
GTTCAGCATCGGTTACGAC -> TTCAGCATCGGTTACGACG
CAACGAGGGATTGTCAGGC -> AACGAGGGATTGTCAGGCT
AATTTGCTAGCTTAGCACC -> ATTTGCTAGCTTAGCACCT
TCGGTGTACTGTCACGCCA -> CGGTGTACTGTCACGCCAC
TTTCACCTTAGGTCTTAGC -> TTCACCTTAGGTCTTAGCA
TAAAAGCTGGTTCACTCAT -> AAAAGCTGGTTCACTCATG
CTGAATCGAGTAGCGGGAC -> TGAATCGAGTAGCGGGACG
CATATTAGACTTGGCGCCT -> ATATTAGACTTGGCGCCTA
GCCTGAATACATGTCGGCC -> CCTGAATACATGTCGGCCT
CTAAATGGTCGGGTCTAGG -> TAAATGGTCGGGTCTAGGG
CGGCCTGACTCACGTCCTG -> GGCCTGACTCACGTCCTGA
GGGAAATCGCTTGGGGGGT -> GGAAATCGCTTGGGGGGTC
AGCACGCGACCGGTAAAAG -> GCACGCGACCGGTAAAAGC
ATGATGCTAAATGGTCGGG -> TGATGCTAAATGGTCGGGT
AGTTTCCCGCCGTAAGCGA -> GTTTCCCGCCGTAAGCGAA
CAGCAAAATAGCATTGGTG -> AGCAAAATAGCATTGGTGA
TATTCCTCGCCGGGGCGCT -> ATTCCTCGCCGGGGCGCTC
TCACTAACTTACGCATACC -> CACTAACTTACGCATACCT
TCCCACCTCTACTCATGAA -> CCCACCTCTACTCATGAAC
TGCTAGCTTAGCACCTCCC -> GCTAGCTTAGCACCTCCCA
CTCAGAATGTGACGACTGA -> TCAGAATGTGACGACTGAT
GTACGTGTGAGTTGGACAG -> TACGTGTGAGTTGGACAGG
GATTCATGCTCCCTTCCAA -> ATTCATGCTCCCTTCCAAT
ATGCTGCAATCCGGAGAGC -> TGCTGCAATCCGGAGAGCC
TTGTATCCGCCCGACAGGC -> TGTATCCGCCCGACAGGCC
ATTTTGACATATGTCGCCA -> TTTTGACATATGTCGCCAC
CCTGTCTGTTCTCATGCTG -> CTGTCTGTTCTCATGCTGC
AGAAATTCGATCTTAATTA -> GAAATTCGATCTTAATTAT
CGCAGCAAATACTCCGGTG -> GCAGCAAATACTCCGGTGA
GGTCTTAGCAATTACCTGA -> GTCTTAGCAATTACCTGAT
ACACAAGTGAGGAAGCGGT -> CACAAGTGAGGAAGCGGTA
GATGTGTGTGTGATTGAGC -> ATGTGTGTGTGATTGAGCA
GATCCCAAATGAACGTCGC -> ATCCCAAATGAACGTCGCA
ACTTACGCATACCTTTGGA -> CTTACGCATACCTTTGGAG
GTCGCATTCATAAGAAAAA -> TCGCATTCATAAGAAAAAG
CTAGTTGTTACGGAGCGCT -> TAGTTGTTACGGAGCGCTT
AGGACGCATTAACCACGAT -> GGACGCATTAACCACGATT
CCTAACGCTATTTCCATGG -> CTAACGCTATTTCCATGGA
ATCATATAGACTTCTGAAT -> TCATATAGACTTCTGAATC
ATGCTAAATGGTCGGGTCT -> TGCTAAATGGTCGGGTCTA
CACTACCTTTTTATAGGAT -> ACTACCTTTTTATAGGATG
GAGTCCGGTACCACCCCAA -> AGTCCGGTACCACCCCAAG
TGCAACCCGCCTAGCATAT -> GCAACCCGCCTAGCATATT
CAGGCCCTTGCAATTAGGA -> AGGCCCTTGCAATTAGGAT
GCGATTCACGCAGCAAATA -> CGATTCACGCAGCAAATAC
TAAGAGCGACAGGAGGACG -> AAGAGCGACAGGAGGACGC
GCCTAACGCTATTTCCATG -> CCTAACGCTATTTCCATGG
ATATAGACTTCTGAATCTG -> TATAGACTTCTGAATCTGA
TGACTCACGTCCTGACTCA -> GACTCACGTCCTGACTCAC
TACACTAACGAATCCAAAA -> ACACTAACGAATCCAAAAG
TATCGAGTCCCGTCCCGGC -> ATCGAGTCCCGTCCCGGCG
GCGAAAAGGACCCTATCGC -> CGAAAAGGACCCTATCGCT
GGTGAGACCCATCGGGCTG -> GTGAGACCCATCGGGCTGT
CTGAGGCCTCACTAACTTA -> TGAGGCCTCACTAACTTAC
AACCACGATTAGCCAGTAG -> ACCACGATTAGCCAGTAGG
ACCAACAACAAAGCGCCGA -> CCAACAACAAAGCGCCGAG
GCACTCGTGGTACCAACAA -> CACTCGTGGTACCAACAAC
GTTACATAATCCCCACTTC -> TTACATAATCCCCACTTCG
ATCTTAATTATCAGTGTTA -> TCTTAATTATCAGTGTTAT
TGGTTCACTCATGAGTGAG -> GGTTCACTCATGAGTGAGC
ACCTGATCTATATTATTCC -> CCTGATCTATATTATTCCT
TGAATCTGATGTGTGTGTG -> GAATCTGATGTGTGTGTGA
AAACCGGGGTCTATACAAA -> AACCGGGGTCTATACAAAC
TGTAAGCTTGTATCCGCCC -> GTAAGCTTGTATCCGCCCG
ACACGCGTAGTTACCCAGA -> CACGCGTAGTTACCCAGAA
AAGCTGGTTCACTCATGAG -> AGCTGGTTCACTCATGAGT
CGTAGTTACCCAGAATCTG -> GTAGTTACCCAGAATCTGG
ATGAGTGAGCTGGCCTATC -> TGAGTGAGCTGGCCTATCG
TTCTCCTACGCATCATATA -> TCTCCTACGCATCATATAG
GGATTAACCAGGAAAGATC -> GATTAACCAGGAAAGATCT
AAGTTCTACGAAGAAGTGT -> AGTTCTACGAAGAAGTGTT
CGCGATTCACGCAGCAAAT -> GCGATTCACGCAGCAAATA
CATTAGATCGTAGTCGCAA -> ATTAGATCGTAGTCGCAAG
AGCAAAATAGCATTGGTGA -> GCAAAATAGCATTGGTGAT
CGTAGTGCACTCGTGGTAC -> GTAGTGCACTCGTGGTACC
GAGCGCCATCAGTAACAAG -> AGCGCCATCAGTAACAAGG
TACTGATCACAGAGTTGGT -> ACTGATCACAGAGTTGGTA
TTGACATATGTCGCCACAT -> TGACATATGTCGCCACATT
AAATCCCTGACTCACGCCT -> AATCCCTGACTCACGCCTG
TCCACTGTTAGTTTCCCGC -> CCACTGTTAGTTTCCCGCC
GTAGAGGCAGTCATCTAAG -> TAGAGGCAGTCATCTAAGC
GGGATTGTCAGGCTACCGA -> GGATTGTCAGGCTACCGAA
TTGCCCGTTGTTTGCCAGT -> TGCCCGTTGTTTGCCAGTA
CTCACGTCCTGACTCACGC -> TCACGTCCTGACTCACGCC
AGACAATGCTAGGCGCTGG -> GACAATGCTAGGCGCTGGA
ATTGGTGATGGAGAAATTC -> TTGGTGATGGAGAAATTCG
CCGCCTAGCATATTAGACT -> CGCCTAGCATATTAGACTT
CAGCAAATACTCCGGTGAG -> AGCAAATACTCCGGTGAGG
CTACGCATCATATAGACTT -> TACGCATCATATAGACTTC
CGCTTGCGCCAGTTGCCGA -> GCTTGCGCCAGTTGCCGAT
GCTCCAGAGTCCGGTACCA -> CTCCAGAGTCCGGTACCAC
TCTGTTCTCATGCTGCAAT -> CTGTTCTCATGCTGCAATC
TGACAGTCCCGGCGTGGCG -> GACAGTCCCGGCGTGGCGT
CCGGTGAGGAACATCATTG -> CGGTGAGGAACATCATTGA
AATCCGGAGAGCCATTCCT -> ATCCGGAGAGCCATTCCTT
CAGTCCCGGCGTGGCGTTC -> AGTCCCGGCGTGGCGTTCA
GAGTCTGCTTTGCGGAGCC -> AGTCTGCTTTGCGGAGCCA
TAGGCAATGCCTGTTTCGC -> AGGCAATGCCTGTTTCGCG
CCCCTGAAGCTCAAGAACA -> CCCTGAAGCTCAAGAACAC
TTACGGAGCGCTTACTCTG -> TACGGAGCGCTTACTCTGT
GTAACAAGGTTATGACGTA -> TAACAAGGTTATGACGTAG
TGTCGGCCTGACTCACGTC -> GTCGGCCTGACTCACGTCC
ACGCATACCTTTGGAGAGA -> CGCATACCTTTGGAGAGAT
ACTTCTACGGTCGTACCTC -> CTTCTACGGTCGTACCTCC
ATAAGACAATGCTAGGCGC -> TAAGACAATGCTAGGCGCT
GAGTACCACGGCCTAACGC -> AGTACCACGGCCTAACGCT
GCGCGAGTCGTCGAACTGG -> CGCGAGTCGTCGAACTGGT
GGCCAATTGCCCGTTGTTT -> GCCAATTGCCCGTTGTTTG
CGAATCCAAAAGTTCTACG -> GAATCCAAAAGTTCTACGA
CGCATCATATAGACTTCTG -> GCATCATATAGACTTCTGA
ACTTCTCCTACGCATCATA -> CTTCTCCTACGCATCATAT
CCGTCCTCTCAAACCGGGG -> CGTCCTCTCAAACCGGGGT
CCACATTGGCGCTGTAGAG -> CACATTGGCGCTGTAGAGG
GTCACGCCACTACCTTTTT -> TCACGCCACTACCTTTTTA
TAGTTACCCAGAATCTGGC -> AGTTACCCAGAATCTGGCC
TTCACTCATGAGTGAGCTG -> TCACTCATGAGTGAGCTGG
ATCAAGGGGCGCGCGAAGG -> TCAAGGGGCGCGCGAAGGA
CCCGTCCCGGCGAGGCATT -> CCGTCCCGGCGAGGCATTC
TCTGTCAACTGCGGGGAAA -> CTGTCAACTGCGGGGAAAT
GGTGAGGAACATCATTGAC -> GTGAGGAACATCATTGACA
AAGATTCATGCTCCCTTCC -> AGATTCATGCTCCCTTCCA
TAACCACGATTAGCCAGTA -> AACCACGATTAGCCAGTAG
AGCGACAGGAGGACGCATT -> GCGACAGGAGGACGCATTA
AGTCGCAAGAACGAGCGGA -> GTCGCAAGAACGAGCGGAT
TTACCCAGAATCTGGCCTC -> TACCCAGAATCTGGCCTCT
AGTTGGTACCTGTCTGTTC -> GTTGGTACCTGTCTGTTCT
GGTCTAAACTGAGGCCTCA -> GTCTAAACTGAGGCCTCAC
CTCAAGAACACAAGTGAGG -> TCAAGAACACAAGTGAGGA
GTGGTACCAACAACAAAGC -> TGGTACCAACAACAAAGCG
GGTTGTTGTAAAGGTCTAA -> GTTGTTGTAAAGGTCTAAA
TAAGCTTGTGTCCCCGCCC -> AAGCTTGTGTCCCCGCCCT
ATGGTCGGGTCTAGGGACA -> TGGTCGGGTCTAGGGACAA
GATAGCTAGTTGTTACGGA -> ATAGCTAGTTGTTACGGAG
CTATCGAATTCTAACTGAA -> TATCGAATTCTAACTGAAA
CAACCGATTCTCTGAGCAC -> AACCGATTCTCTGAGCACC
ACCGCCTAGAGTCGTGCCG -> CCGCCTAGAGTCGTGCCGA
TACCCCATTTTGACATATG -> ACCCCATTTTGACATATGT
TCGGTGGGTATTCCACTGT -> CGGTGGGTATTCCACTGTT
CTGGACCGCCTAGAGTCGT -> TGGACCGCCTAGAGTCGTG
AGCCAGTAGGCAGGTAAGG -> GCCAGTAGGCAGGTAAGGC
GGCGCTGGAGTCTGCTTTG -> GCGCTGGAGTCTGCTTTGC
TCGGGTCTAGGGACAAGTA -> CGGGTCTAGGGACAAGTAC
TGTCACCAACGAGGGATTG -> GTCACCAACGAGGGATTGT
TTGATGCAATCTCGTCAGA -> TGATGCAATCTCGTCAGAT
CTATCGATAAGCACGGCGA -> TATCGATAAGCACGGCGAT
GATGCTAAATGGTCGGGTC -> ATGCTAAATGGTCGGGTCT
CCCATTTTGACATATGTCG -> CCATTTTGACATATGTCGC
TATTTCCATGGAGATACTG -> ATTTCCATGGAGATACTGA
CTTAGGTCTTAGCAATTAC -> TTAGGTCTTAGCAATTACC
CCATTCCTTACATTGTTAG -> CATTCCTTACATTGTTAGA
ACTAGGTTGTTGTAAAGGT -> CTAGGTTGTTGTAAAGGTC
GCGAGGCATTCTGTAACCT -> CGAGGCATTCTGTAACCTG
AGTACCCCATTTTGACATA -> GTACCCCATTTTGACATAT
ATATGTCGCCACATTGGCG -> TATGTCGCCACATTGGCGC
ATAGACTTCTGAATCTGAT -> TAGACTTCTGAATCTGATG
ACCTTTTTATAGGATGTAA -> CCTTTTTATAGGATGTAAG
CCTAACCGGTATGTGTTAC -> CTAACCGGTATGTGTTACA
AGCCATTCCTTACATTGTT -> GCCATTCCTTACATTGTTA
AATTACCTGATCTATATTA -> ATTACCTGATCTATATTAT
TACCAACAACAAAGCGCCG -> ACCAACAACAAAGCGCCGA
GTGTTATAGGTGGCAGGTC -> TGTTATAGGTGGCAGGTCG
CGGTATGTGTTACATAATC -> GGTATGTGTTACATAATCC
CTCTACTCATGAACACCGC -> TCTACTCATGAACACCGCT
CTACTGACCTTCTTTTACG -> TACTGACCTTCTTTTACGG
ATTAGATCGTAGTCGCAAG -> TTAGATCGTAGTCGCAAGA
ATTCATGCTCCCTTCCAAT -> TTCATGCTCCCTTCCAATC
GTTATAGGTGGCAGGTCGG -> TTATAGGTGGCAGGTCGGT
TATTCCACTGTTAGTTTCC -> ATTCCACTGTTAGTTTCCC
TACAAACACGCGTAGTTAC -> ACAAACACGCGTAGTTACC
ACGCTATTTCCATGGAGAT -> CGCTATTTCCATGGAGATA
TCAGGCTACCGAAGTCTTT -> CAGGCTACCGAAGTCTTTG
ATCGCTTGCGCCAGTTGCC -> TCGCTTGCGCCAGTTGCCG
TAACAAGGTTATGACGTAG -> AACAAGGTTATGACGTAGC
CGAACTGGTTTCCGTCCTC -> GAACTGGTTTCCGTCCTCT
CATATGTCGCCACATTGGC -> ATATGTCGCCACATTGGCG
AAAGGACCCTATCGCTTGC -> AAGGACCCTATCGCTTGCG
GAACGAGCGGATGGACTGT -> AACGAGCGGATGGACTGTC
TAAACTGAGGCCTCACTAA -> AAACTGAGGCCTCACTAAC
ACTAACGAATCCAAAAGTT -> CTAACGAATCCAAAAGTTC
AACACAAGTGAGGAAGCGG -> ACACAAGTGAGGAAGCGGT
TAGATCAAGATTCATGCTC -> AGATCAAGATTCATGCTCC
CAGAGTAAACGCATCATAT -> AGAGTAAACGCATCATATA
TATCGATAAGCACGGCGAT -> ATCGATAAGCACGGCGATG
GTACCTCCGCGTGTAGTCA -> TACCTCCGCGTGTAGTCAT
CTTGCAATTAGGATGATAA -> TTGCAATTAGGATGATAAG
CAACTGCGGGGAAATCGCT -> AACTGCGGGGAAATCGCTT
GGTCGGTGTACTGTCACGC -> GTCGGTGTACTGTCACGCC
GATTCATCTAGGCCAATTG -> ATTCATCTAGGCCAATTGC
TGGAGTCTGCTTTGCGGAG -> GGAGTCTGCTTTGCGGAGC
GAATACATGTCGGCCTGAC -> AATACATGTCGGCCTGACT
AGACTTCTGAATCTGATGT -> GACTTCTGAATCTGATGTG
AAATAGCATTGGTGATGGA -> AATAGCATTGGTGATGGAG
CCGGTATGTGTTACATAAT -> CGGTATGTGTTACATAATC
TCCAAAAGTTCTACGAAGA -> CCAAAAGTTCTACGAAGAA
CATCATATAGACTTCTACG -> ATCATATAGACTTCTACGG
TAGCCAGTAGGCAGGTAAG -> AGCCAGTAGGCAGGTAAGG
GCTCAAGAACACAAGTGAG -> CTCAAGAACACAAGTGAGG
GCGCTGTAGAGGCAGTCAT -> CGCTGTAGAGGCAGTCATC
TCCTCTCAAACCGGGGTCT -> CCTCTCAAACCGGGGTCTA
GTCCTATGAGCGAAAAGGA -> TCCTATGAGCGAAAAGGAC
GAGATACTGATCACAGAGT -> AGATACTGATCACAGAGTT
CTCCTACGCATCATATAGA -> TCCTACGCATCATATAGAC
TCTGAATCTGATGTGTGTG -> CTGAATCTGATGTGTGTGT
CCTATCGCTTGCGCCAGTT -> CTATCGCTTGCGCCAGTTG
CATTAACCACGATTAGCCA -> ATTAACCACGATTAGCCAG
TCATATAGACTTCTCCTAC -> CATATAGACTTCTCCTACG
GGCGATGCGCTACTGACCT -> GCGATGCGCTACTGACCTT
CCCATCGGGCTGTCACCAA -> CCATCGGGCTGTCACCAAC
GTTTGTTGCATAACTCATC -> TTTGTTGCATAACTCATCG
ACTCATCGAAGACTAGGTT -> CTCATCGAAGACTAGGTTG
GGAAGCGGTACGTGTGAGT -> GAAGCGGTACGTGTGAGTT
TATGTCGCCACATTGGCGC -> ATGTCGCCACATTGGCGCT
ATTCTAACTGAAATCCCAA -> TTCTAACTGAAATCCCAAC
TGTCTGTTCTCATGCTGCA -> GTCTGTTCTCATGCTGCAA
CGGCCCTGACTACACGAAT -> GGCCCTGACTACACGAATC
CTGCGGTGAGACCCATCGG -> TGCGGTGAGACCCATCGGG
GTCCGTCTCTAGATCAAGA -> TCCGTCTCTAGATCAAGAT
CAAACACGCGTAGTTACCC -> AAACACGCGTAGTTACCCA
CAGGAGGACGCATTAACCA -> AGGAGGACGCATTAACCAC
CGGTGGGTATTCCACTGTT -> GGTGGGTATTCCACTGTTA
TGGAGAAATTCGATCTTAA -> GGAGAAATTCGATCTTAAT
AATCCCCACTTCGAACTGC -> ATCCCCACTTCGAACTGCA
TTCTTTTACGGCTTCATAC -> TCTTTTACGGCTTCATACC
ACGAGCGGATGGACTGTCC -> CGAGCGGATGGACTGTCCG
TTAGTCCTATGAGCGAAAA -> TAGTCCTATGAGCGAAAAG
AACCTGACTCACGCCTGAA -> ACCTGACTCACGCCTGAAT
GTAAGGCCTGCGCGAGTCG -> TAAGGCCTGCGCGAGTCGT
AGGAGGACGCATTAACCAC -> GGAGGACGCATTAACCACG
CGTCCTGACTCACGCCTGA -> GTCCTGACTCACGCCTGAA
TGTTACGGAGCGCTTACTC -> GTTACGGAGCGCTTACTCT
TCATGAACACCGCTTCAAG -> CATGAACACCGCTTCAAGA
ACCCCATTTTGACATATGT -> CCCCATTTTGACATATGTC
AATCCCTGACTCACGCCTG -> ATCCCTGACTCACGCCTGA
CTGGTTTCCGTCCTCTCAA -> TGGTTTCCGTCCTCTCAAA
CGCCTGAATTGTCAGAGTA -> GCCTGAATTGTCAGAGTAA
ACCGGTATGTGTTACATAA -> CCGGTATGTGTTACATAAT
AATCCAAAAGTTCTACGAA -> ATCCAAAAGTTCTACGAAG
TCAGTGTTATAGGTGGCAG -> CAGTGTTATAGGTGGCAGG
GAGCCATTCCTTACATTGT -> AGCCATTCCTTACATTGTT
TGTAGAGGCAGTCATCTAA -> GTAGAGGCAGTCATCTAAG
CTGGAGTCTGCTTTGCGGA -> TGGAGTCTGCTTTGCGGAG
CGCTTCAAGATATCGAGTC -> GCTTCAAGATATCGAGTCC
CGGCGATGCGCTACTGACC -> GGCGATGCGCTACTGACCT
TTGTTAGAGAGTTATGATG -> TGTTAGAGAGTTATGATGC
ACGCGTAGTTACCCAGAAT -> CGCGTAGTTACCCAGAATC
CAATCCGGAGAGCCATTCC -> AATCCGGAGAGCCATTCCT
CTTCCTATCGATAAGCACG -> TTCCTATCGATAAGCACGG
CTTAGCAATTACCTGATCT -> TTAGCAATTACCTGATCTA
TTAACCACGATTAGCCAGT -> TAACCACGATTAGCCAGTA
GTTCCACCAACGCATCATA -> TTCCACCAACGCATCATAT
TACGGTTATCATTAACCGG -> ACGGTTATCATTAACCGGT
AAAGATCTGTCAGTTAGTC -> AAGATCTGTCAGTTAGTCA
CGCCCTGGTATACACTAAC -> GCCCTGGTATACACTAACG
CGTAGAGATCCCAAATGAA -> GTAGAGATCCCAAATGAAC
ATTAACCACGATTAGCCAG -> TTAACCACGATTAGCCAGT
TGACAATTTGCTAGCTTAG -> GACAATTTGCTAGCTTAGC
CGAGGCATTCTGTAACCTG -> GAGGCATTCTGTAACCTGA
GAGGCCTCACTAACTTACG -> AGGCCTCACTAACTTACGC
CGGTGAGACCCATCGGGCT -> GGTGAGACCCATCGGGCTG
CACGCAGCAAATACTCCGG -> ACGCAGCAAATACTCCGGT
CTAGAGTCGTGCCGAACAT -> TAGAGTCGTGCCGAACATA
AATCCGAGTGTTTCACCTT -> ATCCGAGTGTTTCACCTTA
TCAAACCGGGGTCTATACA -> CAAACCGGGGTCTATACAA
TGCATAACTCATCGAAGAC -> GCATAACTCATCGAAGACT
GTAAACGCATCATATAGAC -> TAAACGCATCATATAGACT
ACCGTTGATGCAATCTCGT -> CCGTTGATGCAATCTCGTC
GGGTATTCCACTGTTAGTT -> GGTATTCCACTGTTAGTTT
TTATGATTTCTGGACCGCC -> TATGATTTCTGGACCGCCT
GTTGTTGTAAAGGTCTAAA -> TTGTTGTAAAGGTCTAAAC
TAGAGATCCCAAATGAACG -> AGAGATCCCAAATGAACGT
TGAGGAAGCGGTACGTGTG -> GAGGAAGCGGTACGTGTGA
GAACATAGTTCGGCCCTGA -> AACATAGTTCGGCCCTGAC
TCAAGGGGCGCGCGAAGGA -> CAAGGGGCGCGCGAAGGAT
TGAGGAACATCATTGACAA -> GAGGAACATCATTGACAAT
ATGCCTGTTTCGCGATTCA -> TGCCTGTTTCGCGATTCAC
AACTGCGGGGAAATCGCTT -> ACTGCGGGGAAATCGCTTG
TCTCTAGATCAAGATTCAT -> CTCTAGATCAAGATTCATG
TTGCAAATCCCTGACTCAC -> TGCAAATCCCTGACTCACG
ATGATCCGTAGTGCACTCG -> TGATCCGTAGTGCACTCGT
CAGAATCTGGCCTCTTTGA -> AGAATCTGGCCTCTTTGAT
GCCCTGGTATACACTAACG -> CCCTGGTATACACTAACGA
CTGCAATCCGGAGAGCCAT -> TGCAATCCGGAGAGCCATT
TATGATGCTAAATGGTCGG -> ATGATGCTAAATGGTCGGG
TCCGGAGAGCCATTCCTTA -> CCGGAGAGCCATTCCTTAC
AATGTGACGACTGATCGAG -> ATGTGACGACTGATCGAGC
CTGTCAGTTAGTCAGTCCA -> TGTCAGTTAGTCAGTCCAG
GTCCTCTCAAACCGGGGTC -> TCCTCTCAAACCGGGGTCT
GGGAAGGCAGACTCAGAAT -> GGAAGGCAGACTCAGAATG
CTAGTCTCGGTGGGTATTC -> TAGTCTCGGTGGGTATTCC
TGGCGTTCAGCATCGGTTA -> GGCGTTCAGCATCGGTTAC
TCTCGGTGGGTATTCCACT -> CTCGGTGGGTATTCCACTG
AGCCATTGCAAATCCCTGA -> GCCATTGCAAATCCCTGAC
TTGGTACCTGTCTGTTCTC -> TGGTACCTGTCTGTTCTCA
GGGGCGCTCCAGAGTCCGG -> GGGCGCTCCAGAGTCCGGT
ACCTCCGCGTGTAGTCATT -> CCTCCGCGTGTAGTCATTA
GCCAGTTGCCGATGATCCG -> CCAGTTGCCGATGATCCGT
GATGGAGAAATTCGATCTT -> ATGGAGAAATTCGATCTTA
AAGGATAGCTAGTTGTTAC -> AGGATAGCTAGTTGTTACG
ATGTCGCCACATTGGCGCT -> TGTCGCCACATTGGCGCTG
TCCAATCCGAGTGTTTCAC -> CCAATCCGAGTGTTTCACC
GAGTGTTTCACCTTAGGTC -> AGTGTTTCACCTTAGGTCT
CTCCTGAATGAGTTCCACC -> TCCTGAATGAGTTCCACCA
GCAAAATAGCATTGGTGAT -> CAAAATAGCATTGGTGATG
TTCCAATCCGAGTGTTTCA -> TCCAATCCGAGTGTTTCAC
GAACGTCGCATTCATAAGA -> AACGTCGCATTCATAAGAA
CCTGCGCGAGTCGTCGAAC -> CTGCGCGAGTCGTCGAACT
TGATGCAATCTCGTCAGAT -> GATGCAATCTCGTCAGATT
GGCAGGTCGGTGTACTGTC -> GCAGGTCGGTGTACTGTCA
ATTGCCCGTTGTTTGCCAG -> TTGCCCGTTGTTTGCCAGT
TTAACCAGGAAAGATCTGT -> TAACCAGGAAAGATCTGTC
TCGCTTGCGCCAGTTGCCG -> CGCTTGCGCCAGTTGCCGA
GACCCTATCGCTTGCGCCA -> ACCCTATCGCTTGCGCCAG
AAGTGTTCTCCGTGATCAA -> AGTGTTCTCCGTGATCAAA
GTCAGTTAGTCAGTCCAGC -> TCAGTTAGTCAGTCCAGCA
CCCTGACTCACGCCTGAAT -> CCTGACTCACGCCTGAATC
ATTTGCTAGCTTAGCACCT -> TTTGCTAGCTTAGCACCTC
TGACGTAGCACAATGGGAT -> GACGTAGCACAATGGGATA
CTGTGCCCCCGCCTGCGGT -> TGTGCCCCCGCCTGCGGTG
CGCCTAGGCAATGCCTGTT -> GCCTAGGCAATGCCTGTTT
CATTGCAAATCCCTGACTC -> ATTGCAAATCCCTGACTCA
TCGCATTCATAAGAAAAAG -> CGCATTCATAAGAAAAAGA
GAACACCGCTTCAAGATAT -> AACACCGCTTCAAGATATC
GTGATGGAGAAATTCGATC -> TGATGGAGAAATTCGATCT
TCCTTACATTGTTAGAGAG -> CCTTACATTGTTAGAGAGT
CTATGAGCGAAAAGGACCC -> TATGAGCGAAAAGGACCCT
TACGCATCATATAGACTTC -> ACGCATCATATAGACTTCT
GGACAGGGGCGCAGGGTGG -> GACAGGGGCGCAGGGTGGA
TCGAATTCTAACTGAAATC -> CGAATTCTAACTGAAATCC
TACGACGTAGAGATCCCAA -> ACGACGTAGAGATCCCAAA
GACTTCTACGGTCGTACCT -> ACTTCTACGGTCGTACCTC
TCCGGTACCACCCCAAGCC -> CCGGTACCACCCCAAGCCA
TGAGTGAGCTGGCCTATCG -> GAGTGAGCTGGCCTATCGA
CATGCTCCCTTCCAATCCG -> ATGCTCCCTTCCAATCCGA
CAAGATATCGAGTCCCGTC -> AAGATATCGAGTCCCGTCC
GATATCAAGGGGCGCGCGA -> ATATCAAGGGGCGCGCGAA
CTGTCACGCCACTACCTTT -> TGTCACGCCACTACCTTTT
CGGGGAAATCGCTTGGGGG -> GGGGAAATCGCTTGGGGGG
TAGTCGCAAGAACGAGCGG -> AGTCGCAAGAACGAGCGGA
GTCCAGCAAAATAGCATTG -> TCCAGCAAAATAGCATTGG
AGTTATGATGCTAAATGGT -> GTTATGATGCTAAATGGTC
CGGTCGTACCTCCGCGTGT -> GGTCGTACCTCCGCGTGTA
TCTAGGGACAAGTACCCCA -> CTAGGGACAAGTACCCCAT
CATATAGACTTCTACGGTC -> ATATAGACTTCTACGGTCG
CGCCACTACCTTTTTATAG -> GCCACTACCTTTTTATAGG
TCCTCGCCGGGGCGCTCCA -> CCTCGCCGGGGCGCTCCAG
CATAAGAAAAAGAGTACCA -> ATAAGAAAAAGAGTACCAC
GGTATTCCACTGTTAGTTT -> GTATTCCACTGTTAGTTTC
GCTTACTCTGTCAACTGCG -> CTTACTCTGTCAACTGCGG
CATTCATAAGAAAAAGAGT -> ATTCATAAGAAAAAGAGTA
CCTATCGAATTCTAACTGA -> CTATCGAATTCTAACTGAA
GCATTGGTGATGGAGAAAT -> CATTGGTGATGGAGAAATT
GCGCTACTGACCTTCTTTT -> CGCTACTGACCTTCTTTTA
GTTCGGCCCTGACTACACG -> TTCGGCCCTGACTACACGA
CGTCTCTAGATCAAGATTC -> GTCTCTAGATCAAGATTCA
GTGGGTATTCCACTGTTAG -> TGGGTATTCCACTGTTAGT
GGATTGTCAGGCTACCGAA -> GATTGTCAGGCTACCGAAG
AAGCGCCGAGTCTTCCTAT -> AGCGCCGAGTCTTCCTATC
CTGTCCGTCTCTAGATCAA -> TGTCCGTCTCTAGATCAAG
TAGACTTCTACGGTCGTAC -> AGACTTCTACGGTCGTACC
CCAGGGGGAAGGCAGACTC -> CAGGGGGAAGGCAGACTCA
AATTGCCCGTTGTTTGCCA -> ATTGCCCGTTGTTTGCCAG
CTGTTTCGCGATTCACGCA -> TGTTTCGCGATTCACGCAG
GATCGTAGTCGCAAGAACG -> ATCGTAGTCGCAAGAACGA
TTCACTACACGTCGGTGAT -> TCACTACACGTCGGTGATG
AAATCGCTTGGGGGGTCCT -> AATCGCTTGGGGGGTCCTC
TGTAGTCATTAGATCGTAG -> GTAGTCATTAGATCGTAGT
ATTGACAATTTGCTAGCTT -> TTGACAATTTGCTAGCTTA
AAATGGTCGGGTCTAGGGA -> AATGGTCGGGTCTAGGGAC
AATGCTAGGCGCTGGAGTC -> ATGCTAGGCGCTGGAGTCT
ATGTGTGTGTGATTGAGCA -> TGTGTGTGTGATTGAGCAC
CCGAACATAGTTCGGCCCT -> CGAACATAGTTCGGCCCTG
TGCTGCAATCCGGAGAGCC -> GCTGCAATCCGGAGAGCCA
TGCCGAACATAGTTCGGCC -> GCCGAACATAGTTCGGCCC
ATGTAAGCTTGTATCCGCC -> TGTAAGCTTGTATCCGCCC
GATATCGCTTATATACGGT -> ATATCGCTTATATACGGTT
TAGGTTGTTGTAAAGGTCT -> AGGTTGTTGTAAAGGTCTA
GGTGATGATTATGATTTCT -> GTGATGATTATGATTTCTG
TCGAACTGCAACCCGCCTA -> CGAACTGCAACCCGCCTAG
GTATGTGTTACATAATCCC -> TATGTGTTACATAATCCCC
CTATTTCCATGGAGATACT -> TATTTCCATGGAGATACTG
ATCCGCCCGACAGGCCCTT -> TCCGCCCGACAGGCCCTTG
TATCAAGGGGCGCGCGAAG -> ATCAAGGGGCGCGCGAAGG
CAGATTCATCTAGGCCAAT -> AGATTCATCTAGGCCAATT
AACCGGGGTCTATACAAAC -> ACCGGGGTCTATACAAACA
GTTGTAAAGGTCTAAACTG -> TTGTAAAGGTCTAAACTGA
CCACTGTTAGTTTCCCGCC -> CACTGTTAGTTTCCCGCCG
CGTAGCACAATGGGATACC -> GTAGCACAATGGGATACCC
TGAGCACGCGACCGGTAAA -> GAGCACGCGACCGGTAAAA
AAAAGCTGGTTCACTCATG -> AAAGCTGGTTCACTCATGA
CCACCCCAAGCCACTCCGT -> CACCCCAAGCCACTCCGTT
CAGCATCGGTTACGACGTA -> AGCATCGGTTACGACGTAG
AGTCCGGTACCACCCCAAG -> GTCCGGTACCACCCCAAGC
AAATTCGATCTTAATTATC -> AATTCGATCTTAATTATCA
GGAGATACTGATCACAGAG -> GAGATACTGATCACAGAGT
CGCCACATTGGCGCTGTAG -> GCCACATTGGCGCTGTAGA
CGCTTGGGGGGTCCTCTCA -> GCTTGGGGGGTCCTCTCAC
ATATAGACTTCTACGGTCG -> TATAGACTTCTACGGTCGT
AGCACGGCGATGCGCTACT -> GCACGGCGATGCGCTACTG
CCGTTGTTTGCCAGTAAGA -> CGTTGTTTGCCAGTAAGAG
GCAGCAAATACTCCGGTGA -> CAGCAAATACTCCGGTGAG
TGTCAACTGCGGGGAAATC -> GTCAACTGCGGGGAAATCG
TGTGAGTTGGACAGGGGCG -> GTGAGTTGGACAGGGGCGC
TGTCCCCGCCCTGGTATAC -> GTCCCCGCCCTGGTATACA
GGGGAAGGCAGACTCAGAA -> GGGAAGGCAGACTCAGAAT
CGCAAGAACGAGCGGATGG -> GCAAGAACGAGCGGATGGA
TGTTAGTTTCCCGCCGTAA -> GTTAGTTTCCCGCCGTAAG
CTTCTCCTGAATGAGTTCC -> TTCTCCTGAATGAGTTCCA
CCGCGTGTAGTCATTAGAT -> CGCGTGTAGTCATTAGATC
ACTACACGTCGGTGATGAT -> CTACACGTCGGTGATGATT
ATCTGGCCTCTTTGATATC -> TCTGGCCTCTTTGATATCG
TGCGCTACTGACCTTCTTT -> GCGCTACTGACCTTCTTTT
CTAACGCTATTTCCATGGA -> TAACGCTATTTCCATGGAG
CTACCGAAGTCTTTGTTAG -> TACCGAAGTCTTTGTTAGT
CGCGCGAAGGATAGCTAGT -> GCGCGAAGGATAGCTAGTT
TGTTTGCCAGTAAGAGCGA -> GTTTGCCAGTAAGAGCGAC
CTGATCACAGAGTTGGTAC -> TGATCACAGAGTTGGTACC
CGCCTGCGGTGAGACCCAT -> GCCTGCGGTGAGACCCATC
CAATGCTAGGCGCTGGAGT -> AATGCTAGGCGCTGGAGTC
TGGTCGGGTCTAGGGACAA -> GGTCGGGTCTAGGGACAAG
CGCTACTGACCTTCTTTTA -> GCTACTGACCTTCTTTTAC
CGTTCAGCATCGGTTACGA -> GTTCAGCATCGGTTACGAC
GAGAAATTCGATCTTAATT -> AGAAATTCGATCTTAATTA
ACGTCGGTGATGATTATGA -> CGTCGGTGATGATTATGAT
TCACCTTAGGTCTTAGCAA -> CACCTTAGGTCTTAGCAAT
GTCGGTGATGATTATGATT -> TCGGTGATGATTATGATTT
AGGAACATCATTGACAATT -> GGAACATCATTGACAATTT
GAACTGGTTTCCGTCCTCT -> AACTGGTTTCCGTCCTCTC
TGTTCTCCGTGATCAAATC -> GTTCTCCGTGATCAAATCC
AGCTTGTATCCGCCCGACA -> GCTTGTATCCGCCCGACAG
ACCTTAGGTCTTAGCAATT -> CCTTAGGTCTTAGCAATTA
AAAACCCGGATTAACCAGG -> AAACCCGGATTAACCAGGA
GCCGTAAGCGAAAACCCGG -> CCGTAAGCGAAAACCCGGA
GGAGAGCCATTCCTTACAT -> GAGAGCCATTCCTTACATT
CCCACTTCGAACTGCAACC -> CCACTTCGAACTGCAACCC
CGATTCACGCAGCAAATAC -> GATTCACGCAGCAAATACT
CCTATCGATAAGCACGGCG -> CTATCGATAAGCACGGCGA
CATTGGTGATGGAGAAATT -> ATTGGTGATGGAGAAATTC
TTGACAATTTGCTAGCTTA -> TGACAATTTGCTAGCTTAG
CGTACCTCCGCGTGTAGTC -> GTACCTCCGCGTGTAGTCA
CCTCTACTCATGAACACCG -> CTCTACTCATGAACACCGC
GTAGTGCACTCGTGGTACC -> TAGTGCACTCGTGGTACCA
GATATCGAGTCCCGTCCCG -> ATATCGAGTCCCGTCCCGG
CGTCCTCTCAAACCGGGGT -> GTCCTCTCAAACCGGGGTC
TTGTTTGCCAGTAAGAGCG -> TGTTTGCCAGTAAGAGCGA
ATTCGATCTTAATTATCAG -> TTCGATCTTAATTATCAGT
GTTAGTTTCCCGCCGTAAG -> TTAGTTTCCCGCCGTAAGC
GCCTCACTAACTTACGCAT -> CCTCACTAACTTACGCATA
GAGTTATGATGCTAAATGG -> AGTTATGATGCTAAATGGT
GCATCATATAGACTTCTAC -> CATCATATAGACTTCTACG
GAATTTGACAGTCCCGGCG -> AATTTGACAGTCCCGGCGT
ACGCCTGAATACATGTCGG -> CGCCTGAATACATGTCGGC
CGAGTCGTCGAACTGGTTT -> GAGTCGTCGAACTGGTTTC
GATTATGATTTCTGGACCG -> ATTATGATTTCTGGACCGC
TTCCTCGCCGGGGCGCTCC -> TCCTCGCCGGGGCGCTCCA
AAAAGTTCTACGAAGAAGT -> AAAGTTCTACGAAGAAGTG
CTCATGAACACCGCTTCAA -> TCATGAACACCGCTTCAAG
CGAAGACTAGGTTGTTGTA -> GAAGACTAGGTTGTTGTAA
TGCCGATGATCCGTAGTGC -> GCCGATGATCCGTAGTGCA
CTCCAGAGTCCGGTACCAC -> TCCAGAGTCCGGTACCACC
CATACCCCTGAAGCTCAAG -> ATACCCCTGAAGCTCAAGA
AGAGCCATTCCTTACATTG -> GAGCCATTCCTTACATTGT
GCAATTACCTGATCTATAT -> CAATTACCTGATCTATATT
CCTGCGGTGAGACCCATCG -> CTGCGGTGAGACCCATCGG
TTGTTAGTCCTATGAGCGA -> TGTTAGTCCTATGAGCGAA
TAGCAATTACCTGATCTAT -> AGCAATTACCTGATCTATA
GACCGCCTAGAGTCGTGCC -> ACCGCCTAGAGTCGTGCCG
AACACGCGTAGTTACCCAG -> ACACGCGTAGTTACCCAGA
AACCAATCTAGTCTCGGTG -> ACCAATCTAGTCTCGGTGG
CTCTGAGCACCGTTGATGC -> TCTGAGCACCGTTGATGCA
ATGACGTAGCACAATGGGA -> TGACGTAGCACAATGGGAT
ACAAGTACCCCATTTTGAC -> CAAGTACCCCATTTTGACA
CAAGAACACAAGTGAGGAA -> AAGAACACAAGTGAGGAAG
AAGACAATGCTAGGCGCTG -> AGACAATGCTAGGCGCTGG
CAGGAAAGATCTGTCAGTT -> AGGAAAGATCTGTCAGTTA
TTAGTTTCCCGCCGTAAGC -> TAGTTTCCCGCCGTAAGCG
GCGACCGGTAAAAGCTGGT -> CGACCGGTAAAAGCTGGTT
GCGCCAGTTGCCGATGATC -> CGCCAGTTGCCGATGATCC
TGATGGAGAAATTCGATCT -> GATGGAGAAATTCGATCTT
CATCAGTAACAAGGTTATG -> ATCAGTAACAAGGTTATGA
AAGACTAGGTTGTTGTAAA -> AGACTAGGTTGTTGTAAAG
CACGCGACCGGTAAAAGCT -> ACGCGACCGGTAAAAGCTG
GGCCTCTTTGATATCGCTT -> GCCTCTTTGATATCGCTTA
AGAGTCCGGTACCACCCCA -> GAGTCCGGTACCACCCCAA
CAGGGGCGCAGGGTGGAAT -> AGGGGCGCAGGGTGGAATT
AGCATATTAGACTTGGCGC -> GCATATTAGACTTGGCGCC
AGGCATTCTGTAACCTGAC -> GGCATTCTGTAACCTGACT
TCCTATCGATAAGCACGGC -> CCTATCGATAAGCACGGCG
GTGATGATTATGATTTCTG -> TGATGATTATGATTTCTGG
CGCATTAACCACGATTAGC -> GCATTAACCACGATTAGCC
GCGGAGCCATTGCAAATCC -> CGGAGCCATTGCAAATCCC
CCCGCCTGCGGTGAGACCC -> CCGCCTGCGGTGAGACCCA
AAGGTCTAAACTGAGGCCT -> AGGTCTAAACTGAGGCCTC
CTCGCCGGGGCGCTCCAGA -> TCGCCGGGGCGCTCCAGAG
TGTTTCACCTTAGGTCTTA -> GTTTCACCTTAGGTCTTAG
TCTAGGCCAATTGCCCGTT -> CTAGGCCAATTGCCCGTTG
GCAGACTCAGAATGTGACG -> CAGACTCAGAATGTGACGA
AAGCACGGCGATGCGCTAC -> AGCACGGCGATGCGCTACT
ACAGGGGCGCAGGGTGGAA -> CAGGGGCGCAGGGTGGAAT
TTAGTCAGTCCAGCAAAAT -> TAGTCAGTCCAGCAAAATA
GCTTGGGGGGTCCTCTCAC -> CTTGGGGGGTCCTCTCACC
TGGAATTTCACTACACGTC -> GGAATTTCACTACACGTCG
CAACCCGCCTAGCATATTA -> AACCCGCCTAGCATATTAG
TAACCAATCTAGTCTCGGT -> AACCAATCTAGTCTCGGTG
GTAGCGGGACGCATCATAT -> TAGCGGGACGCATCATATA
CAAGATTCATGCTCCCTTC -> AAGATTCATGCTCCCTTCC
GTTGGTACCTGTCTGTTCT -> TTGGTACCTGTCTGTTCTC
CCTCTTTGATATCGCTTAT -> CTCTTTGATATCGCTTATA
AGTTCGGCCCTGACTACAC -> GTTCGGCCCTGACTACACG
GGTTACGACGTAGAGATCC -> GTTACGACGTAGAGATCCC
TCAAGATTCATGCTCCCTT -> CAAGATTCATGCTCCCTTC
GCGTTCAGCATCGGTTACG -> CGTTCAGCATCGGTTACGA
GATTAACCAGGAAAGATCT -> ATTAACCAGGAAAGATCTG
CCAAAAGTTCTACGAAGAA -> CAAAAGTTCTACGAAGAAG
GCGAGTCGTCGAACTGGTT -> CGAGTCGTCGAACTGGTTT
GAAGTCTTTGTTAGTCCTA -> AAGTCTTTGTTAGTCCTAT
TGTTATAGGTGGCAGGTCG -> GTTATAGGTGGCAGGTCGG
GAGCGACAGGAGGACGCAT -> AGCGACAGGAGGACGCATT
GGAATTTCACTACACGTCG -> GAATTTCACTACACGTCGG
GATAAGACAATGCTAGGCG -> ATAAGACAATGCTAGGCGC
TCTGTCAGTTAGTCAGTCC -> CTGTCAGTTAGTCAGTCCA
ATAAGAAAAAGAGTACCAC -> TAAGAAAAAGAGTACCACG
TGAATACATGTCGGCCTGA -> GAATACATGTCGGCCTGAC
ACACGTCGGTGATGATTAT -> CACGTCGGTGATGATTATG
CAATTGCCCGTTGTTTGCC -> AATTGCCCGTTGTTTGCCA
CTTGGCGCCTAGGCAATGC -> TTGGCGCCTAGGCAATGCC
TGGCAGGTCGGTGTACTGT -> GGCAGGTCGGTGTACTGTC
ACCTGCCAGGGGGAAGGCA -> CCTGCCAGGGGGAAGGCAG
CGAGCGCCATCAGTAACAA -> GAGCGCCATCAGTAACAAG
ATTCCTTACATTGTTAGAG -> TTCCTTACATTGTTAGAGA
CAAGGTTATGACGTAGCAC -> AAGGTTATGACGTAGCACA
CGCGAGTCGTCGAACTGGT -> GCGAGTCGTCGAACTGGTT
CATTCCTTACATTGTTAGA -> ATTCCTTACATTGTTAGAG
ACGACGTAGAGATCCCAAA -> CGACGTAGAGATCCCAAAT
AACACCGCTTCAAGATATC -> ACACCGCTTCAAGATATCG
TCGAGTAGCGGGACGCATC -> CGAGTAGCGGGACGCATCA
GTTACCCAGAATCTGGCCT -> TTACCCAGAATCTGGCCTC
GGCAGTCATCTAAGCTTGT -> GCAGTCATCTAAGCTTGTG
AACGCTATTTCCATGGAGA -> ACGCTATTTCCATGGAGAT
AAATCCCTAACCGGTATGT -> AATCCCTAACCGGTATGTG
AAGCTTGTGTCCCCGCCCT -> AGCTTGTGTCCCCGCCCTG
GCCCTGACTACACGAATCG -> CCCTGACTACACGAATCGG
TCCGTAGTGCACTCGTGGT -> CCGTAGTGCACTCGTGGTA
GCCATTCCTTACATTGTTA -> CCATTCCTTACATTGTTAG
GGGTCCTCTCACCTGCCAG -> GGTCCTCTCACCTGCCAGG
TCACGTCCTGACTCACGCC -> CACGTCCTGACTCACGCCT
GTGTGATTGAGCACGCGAC -> TGTGATTGAGCACGCGACC
CACGGCGATGCGCTACTGA -> ACGGCGATGCGCTACTGAC
CCCGGCGAGGCATTCTGTA -> CCGGCGAGGCATTCTGTAA
GCGCCTAGGCAATGCCTGT -> CGCCTAGGCAATGCCTGTT
GGAGAAATTCGATCTTAAT -> GAGAAATTCGATCTTAATT
TGACCTTCTTTTACGGCTT -> GACCTTCTTTTACGGCTTC
AGAGAGTTATGATGCTAAA -> GAGAGTTATGATGCTAAAT
TTCCCGCCGTAAGCGAAAA -> TCCCGCCGTAAGCGAAAAC
AGAACACAAGTGAGGAAGC -> GAACACAAGTGAGGAAGCG
CAGGGTGGAATTTCACTAC -> AGGGTGGAATTTCACTACA
GCGCTTACTCTGTCAACTG -> CGCTTACTCTGTCAACTGC
ACTGGTTTCCGTCCTCTCA -> CTGGTTTCCGTCCTCTCAA
CTGCAACCCGCCTAGCATA -> TGCAACCCGCCTAGCATAT
TATCGCTTGCGCCAGTTGC -> ATCGCTTGCGCCAGTTGCC
TGACGACTGATCGAGCGCC -> GACGACTGATCGAGCGCCA
TGATCACAGAGTTGGTACC -> GATCACAGAGTTGGTACCT
GCCTGCGCGAGTCGTCGAA -> CCTGCGCGAGTCGTCGAAC
CTCTGTCAACTGCGGGGAA -> TCTGTCAACTGCGGGGAAA
ACATGTCGGCCTGACTCAC -> CATGTCGGCCTGACTCACG
GGGGCGCAGGGTGGAATTT -> GGGCGCAGGGTGGAATTTC
CTCGTCAGATTCATCTAGG -> TCGTCAGATTCATCTAGGC
CAAAGCGCCGAGTCTTCCT -> AAAGCGCCGAGTCTTCCTA
CCCTAACCGGTATGTGTTA -> CCTAACCGGTATGTGTTAC
CAGAATGTGACGACTGATC -> AGAATGTGACGACTGATCG
ACGCCTGAATTGTCAGAGT -> CGCCTGAATTGTCAGAGTA
GTGAGGAAGCGGTACGTGT -> TGAGGAAGCGGTACGTGTG
GTTATGATGCTAAATGGTC -> TTATGATGCTAAATGGTCG
ATTACCTGATCTATATTAT -> TTACCTGATCTATATTATT
ATTCTGTAACCTGACTCAC -> TTCTGTAACCTGACTCACG
TAGAGAGTTATGATGCTAA -> AGAGAGTTATGATGCTAAA
GGTATACACTAACGAATCC -> GTATACACTAACGAATCCA
GAGCGAAAAGGACCCTATC -> AGCGAAAAGGACCCTATCG
GCCTAGGCAATGCCTGTTT -> CCTAGGCAATGCCTGTTTC
TTGTTGCATAACTCATCGA -> TGTTGCATAACTCATCGAA
TTACATAATCCCCACTTCG -> TACATAATCCCCACTTCGA
GAGTTGGTACCTGTCTGTT -> AGTTGGTACCTGTCTGTTC
TGCAATTAGGATGATAAGA -> GCAATTAGGATGATAAGAC
AAATCCCAACGGAATTTGA -> AATCCCAACGGAATTTGAC
GACTCACGTCCTGACTCAC -> ACTCACGTCCTGACTCACG
CGAGTCTTCCTATCGATAA -> GAGTCTTCCTATCGATAAG
CTCACGCCTGAATCGAGTA -> TCACGCCTGAATCGAGTAG
AGTCGTCGAACTGGTTTCC -> GTCGTCGAACTGGTTTCCG
CCGTCTCTAGATCAAGATT -> CGTCTCTAGATCAAGATTC
CGCCGAGTCTTCCTATCGA -> GCCGAGTCTTCCTATCGAT
ATAAGCACGGCGATGCGCT -> TAAGCACGGCGATGCGCTA
GTGTTACATAATCCCCACT -> TGTTACATAATCCCCACTT
CGTTGATGCAATCTCGTCA -> GTTGATGCAATCTCGTCAG
GCATTCATAAGAAAAAGAG -> CATTCATAAGAAAAAGAGT
CGCTCCAGAGTCCGGTACC -> GCTCCAGAGTCCGGTACCA
GCAGTCATCTAAGCTTGTG -> CAGTCATCTAAGCTTGTGT
GGTGGAATTTCACTACACG -> GTGGAATTTCACTACACGT
GAGAGTTATGATGCTAAAT -> AGAGTTATGATGCTAAATG
TGTTGCATAACTCATCGAA -> GTTGCATAACTCATCGAAG
AGCGGATGGACTGTCCGTC -> GCGGATGGACTGTCCGTCT
TACGGTCGTACCTCCGCGT -> ACGGTCGTACCTCCGCGTG
GATTGAGCACGCGACCGGT -> ATTGAGCACGCGACCGGTA
AGGTTATGACGTAGCACAA -> GGTTATGACGTAGCACAAT
CTCACCTGCCAGGGGGAAG -> TCACCTGCCAGGGGGAAGG
GGCTGTCACCAACGAGGGA -> GCTGTCACCAACGAGGGAT
ACGGAGCGCTTACTCTGTC -> CGGAGCGCTTACTCTGTCA
CGGTGATGATTATGATTTC -> GGTGATGATTATGATTTCT
CCAGCAAAATAGCATTGGT -> CAGCAAAATAGCATTGGTG
GGGGCGCGCGAAGGATAGC -> GGGCGCGCGAAGGATAGCT
TTTTTATAGGATGTAAGCT -> TTTTATAGGATGTAAGCTT
TGATTATGATTTCTGGACC -> GATTATGATTTCTGGACCG
GCTTGTGTCCCCGCCCTGG -> CTTGTGTCCCCGCCCTGGT
GCTGGTTCACTCATGAGTG -> CTGGTTCACTCATGAGTGA
GACTCACGCCTGAATACAT -> ACTCACGCCTGAATACATG
GGCATTCTGTAACCTGACT -> GCATTCTGTAACCTGACTC
GTCCTCTCACCTGCCAGGG -> TCCTCTCACCTGCCAGGGG
TGGACCGCCTAGAGTCGTG -> GGACCGCCTAGAGTCGTGC
ATGAGCGAAAAGGACCCTA -> TGAGCGAAAAGGACCCTAT
GGTCTAGGGACAAGTACCC -> GTCTAGGGACAAGTACCCC
ACAATGCTAGGCGCTGGAG -> CAATGCTAGGCGCTGGAGT
TTGTCAGGCTACCGAAGTC -> TGTCAGGCTACCGAAGTCT
GAAGTGTTCTCCGTGATCA -> AAGTGTTCTCCGTGATCAA
CTTCCAATCCGAGTGTTTC -> TTCCAATCCGAGTGTTTCA
AGAGTTATGATGCTAAATG -> GAGTTATGATGCTAAATGG
AGTTGTTACGGAGCGCTTA -> GTTGTTACGGAGCGCTTAC
TCGTGCCGAACATAGTTCG -> CGTGCCGAACATAGTTCGG
ACATTGTTAGAGAGTTATG -> CATTGTTAGAGAGTTATGA
TGTGTGTGATTGAGCACGC -> GTGTGTGATTGAGCACGCG
TAGTTTCCCGCCGTAAGCG -> AGTTTCCCGCCGTAAGCGA
GCACCGTTGATGCAATCTC -> CACCGTTGATGCAATCTCG
CATTGGCGCTGTAGAGGCA -> ATTGGCGCTGTAGAGGCAG
TAGGCAGGTAAGGCCTGCG -> AGGCAGGTAAGGCCTGCGC
TATGTGTTACATAATCCCC -> ATGTGTTACATAATCCCCA
CCATTTTGACATATGTCGC -> CATTTTGACATATGTCGCC
CGTGTAGTCATTAGATCGT -> GTGTAGTCATTAGATCGTA
CGCTGGAGTCTGCTTTGCG -> GCTGGAGTCTGCTTTGCGG
TCGGTGATGATTATGATTT -> CGGTGATGATTATGATTTC
AGGCCAATTGCCCGTTGTT -> GGCCAATTGCCCGTTGTTT
TCTTTTACGGCTTCATACC -> CTTTTACGGCTTCATACCC
CTTTGGAGAGATATCAAGG -> TTTGGAGAGATATCAAGGG
CCGATTCTCTGAGCACCGT -> CGATTCTCTGAGCACCGTT
GAGTCGTCGAACTGGTTTC -> AGTCGTCGAACTGGTTTCC
TCTGAGCACCGTTGATGCA -> CTGAGCACCGTTGATGCAA
ATTTGACAGTCCCGGCGTG -> TTTGACAGTCCCGGCGTGG
TTATAGGTGGCAGGTCGGT -> TATAGGTGGCAGGTCGGTG
ATCTAAGCTTGTGTCCCCG -> TCTAAGCTTGTGTCCCCGC
GCTGGAGTCTGCTTTGCGG -> CTGGAGTCTGCTTTGCGGA
GTTGTTACGGAGCGCTTAC -> TTGTTACGGAGCGCTTACT
CCCTGGTATACACTAACGA -> CCTGGTATACACTAACGAA
CACCGCTTCAAGATATCGA -> ACCGCTTCAAGATATCGAG
CATATAGACTTCTCCTGAA -> ATATAGACTTCTCCTGAAT
AGGCCTCACTAACTTACGC -> GGCCTCACTAACTTACGCA
GCGCGCGAAGGATAGCTAG -> CGCGCGAAGGATAGCTAGT
CACCAACGAGGGATTGTCA -> ACCAACGAGGGATTGTCAG
CAAGAACGAGCGGATGGAC -> AAGAACGAGCGGATGGACT
TACCTTTTTATAGGATGTA -> ACCTTTTTATAGGATGTAA
CCCCGCCTGCGGTGAGACC -> CCCGCCTGCGGTGAGACCC
TCCTGACTCACGCCTGAAT -> CCTGACTCACGCCTGAATT
CTAACTGAAATCCCAACGG -> TAACTGAAATCCCAACGGA
ACCTTCTTTTACGGCTTCA -> CCTTCTTTTACGGCTTCAT
CTTCTTTTACGGCTTCATA -> TTCTTTTACGGCTTCATAC
AGATATCAAGGGGCGCGCG -> GATATCAAGGGGCGCGCGA
TAAATGGTCGGGTCTAGGG -> AAATGGTCGGGTCTAGGGA
CCATGGAGATACTGATCAC -> CATGGAGATACTGATCACA
TCACCTGCCAGGGGGAAGG -> CACCTGCCAGGGGGAAGGC
TTCTCCGTGATCAAATCCC -> TCTCCGTGATCAAATCCCT
AGCTTAGCACCTCCCACCT -> GCTTAGCACCTCCCACCTC
CTAACCGGTATGTGTTACA -> TAACCGGTATGTGTTACAT
GATCGAGCGCCATCAGTAA -> ATCGAGCGCCATCAGTAAC
CGCATCATATAGACTTCTC -> GCATCATATAGACTTCTCC,GCATCATATAGACTTCTCC
ACTCAGAATGTGACGACTG -> CTCAGAATGTGACGACTGA
AGGCTACCGAAGTCTTTGT -> GGCTACCGAAGTCTTTGTT
GGTACCTGTCTGTTCTCAT -> GTACCTGTCTGTTCTCATG
TCCGTCCTCTCAAACCGGG -> CCGTCCTCTCAAACCGGGG
GGACCCTATCGCTTGCGCC -> GACCCTATCGCTTGCGCCA
TAGCACAATGGGATACCCG -> AGCACAATGGGATACCCGA
TTAGATCGTAGTCGCAAGA -> TAGATCGTAGTCGCAAGAA
AGAGTACCACGGCCTAACG -> GAGTACCACGGCCTAACGC
CCGTGATCAAATCCCTAAC -> CGTGATCAAATCCCTAACC
CTGACCTTCTTTTACGGCT -> TGACCTTCTTTTACGGCTT
CCGGGGTCTATACAAACAC -> CGGGGTCTATACAAACACG
TGTCCGTCTCTAGATCAAG -> GTCCGTCTCTAGATCAAGA
TCGCGATTCACGCAGCAAA -> CGCGATTCACGCAGCAAAT
TTTCTGGACCGCCTAGAGT -> TTCTGGACCGCCTAGAGTC
CACCGTTGATGCAATCTCG -> ACCGTTGATGCAATCTCGT
CGTAGTCGCAAGAACGAGC -> GTAGTCGCAAGAACGAGCG
TGATAAGACAATGCTAGGC -> GATAAGACAATGCTAGGCG
AGGTAAGGCCTGCGCGAGT -> GGTAAGGCCTGCGCGAGTC
GGTAAGGCCTGCGCGAGTC -> GTAAGGCCTGCGCGAGTCG
CACAGAGTTGGTACCTGTC -> ACAGAGTTGGTACCTGTCT
TGATATCGCTTATATACGG -> GATATCGCTTATATACGGT
GTAAGAGCGACAGGAGGAC -> TAAGAGCGACAGGAGGACG
CTGACTCACGCCTGAATTG -> TGACTCACGCCTGAATTGT
GGCGCTCCAGAGTCCGGTA -> GCGCTCCAGAGTCCGGTAC
GTCGCAAGAACGAGCGGAT -> TCGCAAGAACGAGCGGATG
GAGCCATTGCAAATCCCTG -> AGCCATTGCAAATCCCTGA
ATCCGAGTGTTTCACCTTA -> TCCGAGTGTTTCACCTTAG
GTGGCGTTCAGCATCGGTT -> TGGCGTTCAGCATCGGTTA
CGTCGGTGATGATTATGAT -> GTCGGTGATGATTATGATT
ACTCACGCCTGAATTGTCA -> CTCACGCCTGAATTGTCAG
GCGTGTAGTCATTAGATCG -> CGTGTAGTCATTAGATCGT
ACGTGTGAGTTGGACAGGG -> CGTGTGAGTTGGACAGGGG
GCCGGGGCGCTCCAGAGTC -> CCGGGGCGCTCCAGAGTCC
TCCGTTTGTTGCATAACTC -> CCGTTTGTTGCATAACTCA
GGCGTTCAGCATCGGTTAC -> GCGTTCAGCATCGGTTACG
AGGTTGTTGTAAAGGTCTA -> GGTTGTTGTAAAGGTCTAA
CCCCATTTTGACATATGTC -> CCCATTTTGACATATGTCG
TTCATACCCCTGAAGCTCA -> TCATACCCCTGAAGCTCAA
AGATCGTAGTCGCAAGAAC -> GATCGTAGTCGCAAGAACG
TGGCGCTGTAGAGGCAGTC -> GGCGCTGTAGAGGCAGTCA
AGTGAGGAAGCGGTACGTG -> GTGAGGAAGCGGTACGTGT
GTCGGCCTGACTCACGTCC -> TCGGCCTGACTCACGTCCT
AGCACAATGGGATACCCGA -> GCACAATGGGATACCCGAA
GTACCACGGCCTAACGCTA -> TACCACGGCCTAACGCTAT
CTAGCTTAGCACCTCCCAC -> TAGCTTAGCACCTCCCACC
AGAATGTGACGACTGATCG -> GAATGTGACGACTGATCGA
TACTCATGAACACCGCTTC -> ACTCATGAACACCGCTTCA
AGATCCCAAATGAACGTCG -> GATCCCAAATGAACGTCGC
GGAGGACGCATTAACCACG -> GAGGACGCATTAACCACGA
GCGGGGAAATCGCTTGGGG -> CGGGGAAATCGCTTGGGGG
CTTGCGCCAGTTGCCGATG -> TTGCGCCAGTTGCCGATGA
CCTGATCTATATTATTCCT -> CTGATCTATATTATTCCTC
AGAAAAAGAGTACCACGGC -> GAAAAAGAGTACCACGGCC
CCCGGCGTGGCGTTCAGCA -> CCGGCGTGGCGTTCAGCAT
TTCCACCAACGCATCATAT -> TCCACCAACGCATCATATA
GGTTATCATTAACCGGTAA -> GTTATCATTAACCGGTAAC
AGGTCGGTGTACTGTCACG -> GGTCGGTGTACTGTCACGC
TTCTGGACCGCCTAGAGTC -> TCTGGACCGCCTAGAGTCG
CTCTAGATCAAGATTCATG -> TCTAGATCAAGATTCATGC
GCAGGTCGGTGTACTGTCA -> CAGGTCGGTGTACTGTCAC
GTCGAACTGGTTTCCGTCC -> TCGAACTGGTTTCCGTCCT
GGCAGACTCAGAATGTGAC -> GCAGACTCAGAATGTGACG
TCAACCGATTCTCTGAGCA -> CAACCGATTCTCTGAGCAC
ATAATCCCCACTTCGAACT -> TAATCCCCACTTCGAACTG
TTTCACTACACGTCGGTGA -> TTCACTACACGTCGGTGAT
CTACCTTTTTATAGGATGT -> TACCTTTTTATAGGATGTA
AATGCCTGTTTCGCGATTC -> ATGCCTGTTTCGCGATTCA
TCTGGCCTCTTTGATATCG -> CTGGCCTCTTTGATATCGC
TACGCATACCTTTGGAGAG -> ACGCATACCTTTGGAGAGA
AGTTGCCGATGATCCGTAG -> GTTGCCGATGATCCGTAGT
GGGACAAGTACCCCATTTT -> GGACAAGTACCCCATTTTG
TGACTCACGCCTGAATTGT -> GACTCACGCCTGAATTGTC
CCTAGGCAATGCCTGTTTC -> CTAGGCAATGCCTGTTTCG
TCCTACGCATCATATAGAC -> CCTACGCATCATATAGACT
CTAGGCAATGCCTGTTTCG -> TAGGCAATGCCTGTTTCGC
CATTGTTAGAGAGTTATGA -> ATTGTTAGAGAGTTATGAT
GTCAGAGTAAACGCATCAT -> TCAGAGTAAACGCATCATA
CAACAACAAAGCGCCGAGT -> AACAACAAAGCGCCGAGTC
GTCATCTAAGCTTGTGTCC -> TCATCTAAGCTTGTGTCCC
CATCTAAGCTTGTGTCCCC -> ATCTAAGCTTGTGTCCCCG
GATCAAGATTCATGCTCCC -> ATCAAGATTCATGCTCCCT
TGGCGCCTAGGCAATGCCT -> GGCGCCTAGGCAATGCCTG
CGCCGTAAGCGAAAACCCG -> GCCGTAAGCGAAAACCCGG
GAAATCGCTTGGGGGGTCC -> AAATCGCTTGGGGGGTCCT
GTCTGTTCTCATGCTGCAA -> TCTGTTCTCATGCTGCAAT
AGTCAGTCCAGCAAAATAG -> GTCAGTCCAGCAAAATAGC
GCAAATCCCTGACTCACGC -> CAAATCCCTGACTCACGCC
ATCTCGTCAGATTCATCTA -> TCTCGTCAGATTCATCTAG
AGCGCCGAGTCTTCCTATC -> GCGCCGAGTCTTCCTATCG
GCAATTAGGATGATAAGAC -> CAATTAGGATGATAAGACA
ACTCACGTCCTGACTCACG -> CTCACGTCCTGACTCACGC
TCCCGCCGTAAGCGAAAAC -> CCCGCCGTAAGCGAAAACC
TAACTGAAATCCCAACGGA -> AACTGAAATCCCAACGGAA
CTCATGCTGCAATCCGGAG -> TCATGCTGCAATCCGGAGA
CGGTTATCATTAACCGGTA -> GGTTATCATTAACCGGTAA
TGGTATACACTAACGAATC -> GGTATACACTAACGAATCC
ATCCGTAGTGCACTCGTGG -> TCCGTAGTGCACTCGTGGT
TTATCATTAACCGGTAACC -> TATCATTAACCGGTAACCA
TTCTAACTGAAATCCCAAC -> TCTAACTGAAATCCCAACG
GAGGCAGTCATCTAAGCTT -> AGGCAGTCATCTAAGCTTG
CAATTACCTGATCTATATT -> AATTACCTGATCTATATTA
GTCCCGGCGAGGCATTCTG -> TCCCGGCGAGGCATTCTGT
GGGCGCAGGGTGGAATTTC -> GGCGCAGGGTGGAATTTCA
TTTTGACATATGTCGCCAC -> TTTGACATATGTCGCCACA
ACTAACTTACGCATACCTT -> CTAACTTACGCATACCTTT
CAGGTCGGTGTACTGTCAC -> AGGTCGGTGTACTGTCACG
TGAATGAGTTCCACCAACG -> GAATGAGTTCCACCAACGC
TCTACGAAGAAGTGTTCTC -> CTACGAAGAAGTGTTCTCC
GAACCTAGGGCCTGTGCCC -> AACCTAGGGCCTGTGCCCC
GGATGGACTGTCCGTCTCT -> GATGGACTGTCCGTCTCTA
CTTCTACGGTCGTACCTCC -> TTCTACGGTCGTACCTCCG
CACTCGTGGTACCAACAAC -> ACTCGTGGTACCAACAACA
GATCAAATCCCTAACCGGT -> ATCAAATCCCTAACCGGTA
AAGCGGTACGTGTGAGTTG -> AGCGGTACGTGTGAGTTGG
GTAGTTACCCAGAATCTGG -> TAGTTACCCAGAATCTGGC
ACTCATGAACACCGCTTCA -> CTCATGAACACCGCTTCAA
AGTCCTATGAGCGAAAAGG -> GTCCTATGAGCGAAAAGGA
TAGATCGTAGTCGCAAGAA -> AGATCGTAGTCGCAAGAAC
TGATCCGTAGTGCACTCGT -> GATCCGTAGTGCACTCGTG
GGCCCTGACTACACGAATC -> GCCCTGACTACACGAATCG
TACCCCTGAAGCTCAAGAA -> ACCCCTGAAGCTCAAGAAC
ATAGTTCGGCCCTGACTAC -> TAGTTCGGCCCTGACTACA
GCCGAACATAGTTCGGCCC -> CCGAACATAGTTCGGCCCT
TTAGAGAGTTATGATGCTA -> TAGAGAGTTATGATGCTAA
TATGATTTCTGGACCGCCT -> ATGATTTCTGGACCGCCTA
TCCAGAGTCCGGTACCACC -> CCAGAGTCCGGTACCACCC
CACTAACTTACGCATACCT -> ACTAACTTACGCATACCTT
GCATACCTTTGGAGAGATA -> CATACCTTTGGAGAGATAT
TGAACGTCGCATTCATAAG -> GAACGTCGCATTCATAAGA
CCAATCCGAGTGTTTCACC -> CAATCCGAGTGTTTCACCT
CCCTGAAGCTCAAGAACAC -> CCTGAAGCTCAAGAACACA
CCTCTCAAACCGGGGTCTA -> CTCTCAAACCGGGGTCTAT
AGTCTCGGTGGGTATTCCA -> GTCTCGGTGGGTATTCCAC
CAGGTAAGGCCTGCGCGAG -> AGGTAAGGCCTGCGCGAGT
TTGTTACGGAGCGCTTACT -> TGTTACGGAGCGCTTACTC
CCAACGAGGGATTGTCAGG -> CAACGAGGGATTGTCAGGC
CCGACAGGCCCTTGCAATT -> CGACAGGCCCTTGCAATTA
GCTAGTTGTTACGGAGCGC -> CTAGTTGTTACGGAGCGCT
ATCGAAGACTAGGTTGTTG -> TCGAAGACTAGGTTGTTGT
TCACCAACGAGGGATTGTC -> CACCAACGAGGGATTGTCA
TGTTAGTCCTATGAGCGAA -> GTTAGTCCTATGAGCGAAA
GCGATGCGCTACTGACCTT -> CGATGCGCTACTGACCTTC
ATAACTCATCGAAGACTAG -> TAACTCATCGAAGACTAGG
GGTACCAACAACAAAGCGC -> GTACCAACAACAAAGCGCC
AAGCGAAAACCCGGATTAA -> AGCGAAAACCCGGATTAAC
GATGTAAGCTTGTATCCGC -> ATGTAAGCTTGTATCCGCC
CGCCGGGGCGCTCCAGAGT -> GCCGGGGCGCTCCAGAGTC
CTTCATACCCCTGAAGCTC -> TTCATACCCCTGAAGCTCA
TCATATAGACTTCTCCTGA -> CATATAGACTTCTCCTGAA
CATATAGACTTCTGAATCT -> ATATAGACTTCTGAATCTG
CTGCGGGGAAATCGCTTGG -> TGCGGGGAAATCGCTTGGG
TCCCTTCCAATCCGAGTGT -> CCCTTCCAATCCGAGTGTT
TATGAGCGAAAAGGACCCT -> ATGAGCGAAAAGGACCCTA
TGCGGAGCCATTGCAAATC -> GCGGAGCCATTGCAAATCC
TATACAAACACGCGTAGTT -> ATACAAACACGCGTAGTTA
CGATAAGCACGGCGATGCG -> GATAAGCACGGCGATGCGC
GTCTTAGCAATTACCTGAT -> TCTTAGCAATTACCTGATC
AAGAGTACCACGGCCTAAC -> AGAGTACCACGGCCTAACG
GCGCAGGGTGGAATTTCAC -> CGCAGGGTGGAATTTCACT
GGAGCGCTTACTCTGTCAA -> GAGCGCTTACTCTGTCAAC
GCACAATGGGATACCCGAA -> CACAATGGGATACCCGAAC
ACGATTAGCCAGTAGGCAG -> CGATTAGCCAGTAGGCAGG
TGCCAGGGGGAAGGCAGAC -> GCCAGGGGGAAGGCAGACT
CGGTGTACTGTCACGCCAC -> GGTGTACTGTCACGCCACT
CCACTCCGTTTGTTGCATA -> CACTCCGTTTGTTGCATAA
TTGTAAAGGTCTAAACTGA -> TGTAAAGGTCTAAACTGAG
CGCCTAGCATATTAGACTT -> GCCTAGCATATTAGACTTG
ATGATTATGATTTCTGGAC -> TGATTATGATTTCTGGACC
GCTAAATGGTCGGGTCTAG -> CTAAATGGTCGGGTCTAGG
GGATGTAAGCTTGTATCCG -> GATGTAAGCTTGTATCCGC
TTCACGCAGCAAATACTCC -> TCACGCAGCAAATACTCCG
CGGCTTCATACCCCTGAAG -> GGCTTCATACCCCTGAAGC
ATGATAAGACAATGCTAGG -> TGATAAGACAATGCTAGGC
CAAATCCCTAACCGGTATG -> AAATCCCTAACCGGTATGT
GCTTCATACCCCTGAAGCT -> CTTCATACCCCTGAAGCTC
GGGCGCGCGAAGGATAGCT -> GGCGCGCGAAGGATAGCTA
CACGGCCTAACGCTATTTC -> ACGGCCTAACGCTATTTCC
GGGGGAAGGCAGACTCAGA -> GGGGAAGGCAGACTCAGAA
CACTGTTAGTTTCCCGCCG -> ACTGTTAGTTTCCCGCCGT
TAAGACAATGCTAGGCGCT -> AAGACAATGCTAGGCGCTG
ATATAGACTTCTCCTGAAT -> TATAGACTTCTCCTGAATG
ATACCCGAACCTAGGGCCT -> TACCCGAACCTAGGGCCTG
AATTTCACTACACGTCGGT -> ATTTCACTACACGTCGGTG
TAAGGCCTGCGCGAGTCGT -> AAGGCCTGCGCGAGTCGTC
TCAAATCCCTAACCGGTAT -> CAAATCCCTAACCGGTATG
CCGGCGAGGCATTCTGTAA -> CGGCGAGGCATTCTGTAAC
TCTAACTGAAATCCCAACG -> CTAACTGAAATCCCAACGG
ACTGCAACCCGCCTAGCAT -> CTGCAACCCGCCTAGCATA
CCGGAGAGCCATTCCTTAC -> CGGAGAGCCATTCCTTACA
CCACGATTAGCCAGTAGGC -> CACGATTAGCCAGTAGGCA
CTATCGCTTGCGCCAGTTG -> TATCGCTTGCGCCAGTTGC
GTCTAGGGACAAGTACCCC -> TCTAGGGACAAGTACCCCA
CCGTCCCGGCGAGGCATTC -> CGTCCCGGCGAGGCATTCT
TAGCATATTAGACTTGGCG -> AGCATATTAGACTTGGCGC
AATTAGGATGATAAGACAA -> ATTAGGATGATAAGACAAT
ATAGCATTGGTGATGGAGA -> TAGCATTGGTGATGGAGAA
GTCTTCCTATCGATAAGCA -> TCTTCCTATCGATAAGCAC
GCCGAGTCTTCCTATCGAT -> CCGAGTCTTCCTATCGATA
CCTCACTAACTTACGCATA -> CTCACTAACTTACGCATAC
CGGTAACCAATCTAGTCTC -> GGTAACCAATCTAGTCTCG
TATGACGTAGCACAATGGG -> ATGACGTAGCACAATGGGA
CGACAGGCCCTTGCAATTA -> GACAGGCCCTTGCAATTAG
ACCGGTAAAAGCTGGTTCA -> CCGGTAAAAGCTGGTTCAC
TTGGACAGGGGCGCAGGGT -> TGGACAGGGGCGCAGGGTG
CAATTTGCTAGCTTAGCAC -> AATTTGCTAGCTTAGCACC
TACCCAGAATCTGGCCTCT -> ACCCAGAATCTGGCCTCTT
CAGAGTTGGTACCTGTCTG -> AGAGTTGGTACCTGTCTGT
TACCTGTCTGTTCTCATGC -> ACCTGTCTGTTCTCATGCT
GAAGCTCAAGAACACAAGT -> AAGCTCAAGAACACAAGTG
AAGGCAGACTCAGAATGTG -> AGGCAGACTCAGAATGTGA
TACATAATCCCCACTTCGA -> ACATAATCCCCACTTCGAA
TAAGCTTGTATCCGCCCGA -> AAGCTTGTATCCGCCCGAC
TTTGCGGAGCCATTGCAAA -> TTGCGGAGCCATTGCAAAT
TGGGTATTCCACTGTTAGT -> GGGTATTCCACTGTTAGTT
GGAACATCATTGACAATTT -> GAACATCATTGACAATTTG
TGTGTTACATAATCCCCAC -> GTGTTACATAATCCCCACT
GCATCATATAGACTTCTCC -> CATCATATAGACTTCTCCT,CATCATATAGACTTCTCCT
TGAGACCCATCGGGCTGTC -> GAGACCCATCGGGCTGTCA
ACTGAAATCCCAACGGAAT -> CTGAAATCCCAACGGAATT
TACACGTCGGTGATGATTA -> ACACGTCGGTGATGATTAT
TATAGGTGGCAGGTCGGTG -> ATAGGTGGCAGGTCGGTGT
TAGCGGGACGCATCATATA -> AGCGGGACGCATCATATAG
GATTGTCAGGCTACCGAAG -> ATTGTCAGGCTACCGAAGT
GTACCAACAACAAAGCGCC -> TACCAACAACAAAGCGCCG
AAGTGAGGAAGCGGTACGT -> AGTGAGGAAGCGGTACGTG
CTCACTAACTTACGCATAC -> TCACTAACTTACGCATACC
AACTGAAATCCCAACGGAA -> ACTGAAATCCCAACGGAAT
CATAACTCATCGAAGACTA -> ATAACTCATCGAAGACTAG
TCCCAACGGAATTTGACAG -> CCCAACGGAATTTGACAGT
AGTTACCCAGAATCTGGCC -> GTTACCCAGAATCTGGCCT
CATCGGTTACGACGTAGAG -> ATCGGTTACGACGTAGAGA
TAGGATGATAAGACAATGC -> AGGATGATAAGACAATGCT
TCGAGCGCCATCAGTAACA -> CGAGCGCCATCAGTAACAA
TCTACTCATGAACACCGCT -> CTACTCATGAACACCGCTT
AAAGCTGGTTCACTCATGA -> AAGCTGGTTCACTCATGAG
TCTAAACTGAGGCCTCACT -> CTAAACTGAGGCCTCACTA
TCCAGCAAAATAGCATTGG -> CCAGCAAAATAGCATTGGT
GGCCTCACTAACTTACGCA -> GCCTCACTAACTTACGCAT
TGCACTCGTGGTACCAACA -> GCACTCGTGGTACCAACAA
GATTAGCCAGTAGGCAGGT -> ATTAGCCAGTAGGCAGGTA
CTTACATTGTTAGAGAGTT -> TTACATTGTTAGAGAGTTA
GTAGTCATTAGATCGTAGT -> TAGTCATTAGATCGTAGTC
GTACCCCATTTTGACATAT -> TACCCCATTTTGACATATG
CTTGGGGGGTCCTCTCACC -> TTGGGGGGTCCTCTCACCT
TGCCAGTAAGAGCGACAGG -> GCCAGTAAGAGCGACAGGA
CTTCGAACTGCAACCCGCC -> TTCGAACTGCAACCCGCCT
AGGTCTTAGCAATTACCTG -> GGTCTTAGCAATTACCTGA
CCCGTTGTTTGCCAGTAAG -> CCGTTGTTTGCCAGTAAGA
TGCTCCCTTCCAATCCGAG -> GCTCCCTTCCAATCCGAGT
TAGTTGTTACGGAGCGCTT -> AGTTGTTACGGAGCGCTTA
GTAGCACAATGGGATACCC -> TAGCACAATGGGATACCCG
TCGTACCTCCGCGTGTAGT -> CGTACCTCCGCGTGTAGTC
GCCTCTTTGATATCGCTTA -> CCTCTTTGATATCGCTTAT
GTGCACTCGTGGTACCAAC -> TGCACTCGTGGTACCAACA
AGAGCGACAGGAGGACGCA -> GAGCGACAGGAGGACGCAT
TTATTCCTCGCCGGGGCGC -> TATTCCTCGCCGGGGCGCT
TGAGCACCGTTGATGCAAT -> GAGCACCGTTGATGCAATC
GTAACCTGACTCACGCCTG -> TAACCTGACTCACGCCTGA
ATCATATAGACTTCTCCTA -> TCATATAGACTTCTCCTAC
TGAATCGAGTAGCGGGACG -> GAATCGAGTAGCGGGACGC
CGCATCATATAGACTTCTA -> GCATCATATAGACTTCTAC
CTGCTTTGCGGAGCCATTG -> TGCTTTGCGGAGCCATTGC
TAGAGTCGTGCCGAACATA -> AGAGTCGTGCCGAACATAG
ACTGAGGCCTCACTAACTT -> CTGAGGCCTCACTAACTTA
AGTAGGCAGGTAAGGCCTG -> GTAGGCAGGTAAGGCCTGC
AGAGTCGTGCCGAACATAG -> GAGTCGTGCCGAACATAGT
GGTACCACCCCAAGCCACT -> GTACCACCCCAAGCCACTC
ACCACCCCAAGCCACTCCG -> CCACCCCAAGCCACTCCGT
CAAGGGGCGCGCGAAGGAT -> AAGGGGCGCGCGAAGGATA
AAGAAGTGTTCTCCGTGAT -> AGAAGTGTTCTCCGTGATC
CGTCAGATTCATCTAGGCC -> GTCAGATTCATCTAGGCCA
AAGCTTGTATCCGCCCGAC -> AGCTTGTATCCGCCCGACA
GAAGACTAGGTTGTTGTAA -> AAGACTAGGTTGTTGTAAA
ATCAGTGTTATAGGTGGCA -> TCAGTGTTATAGGTGGCAG
TACCTGATCTATATTATTC -> ACCTGATCTATATTATTCC
AAGTACCCCATTTTGACAT -> AGTACCCCATTTTGACATA
TCCACCAACGCATCATATA -> CCACCAACGCATCATATAG
CATCATATAGACTTCTCCT -> ATCATATAGACTTCTCCTG,ATCATATAGACTTCTCCTA
CTGATGTGTGTGTGATTGA -> TGATGTGTGTGTGATTGAG
GGGGTCTATACAAACACGC -> GGGTCTATACAAACACGCG
ACGTCGCATTCATAAGAAA -> CGTCGCATTCATAAGAAAA
GCTGTAGAGGCAGTCATCT -> CTGTAGAGGCAGTCATCTA
CCCTGACTACACGAATCGG -> CCTGACTACACGAATCGGC
TACCACCCCAAGCCACTCC -> ACCACCCCAAGCCACTCCG
CAGAGTCCGGTACCACCCC -> AGAGTCCGGTACCACCCCA
GTGTCCCCGCCCTGGTATA -> TGTCCCCGCCCTGGTATAC
AGTAAGAGCGACAGGAGGA -> GTAAGAGCGACAGGAGGAC
ACCCTATCGCTTGCGCCAG -> CCCTATCGCTTGCGCCAGT
AAGAACGAGCGGATGGACT -> AGAACGAGCGGATGGACTG
GCCTGCGGTGAGACCCATC -> CCTGCGGTGAGACCCATCG
CGTGGCGTTCAGCATCGGT -> GTGGCGTTCAGCATCGGTT
GTTACGACGTAGAGATCCC -> TTACGACGTAGAGATCCCA
ATCTAGTCTCGGTGGGTAT -> TCTAGTCTCGGTGGGTATT
TACCCGAACCTAGGGCCTG -> ACCCGAACCTAGGGCCTGT
AACGTCGCATTCATAAGAA -> ACGTCGCATTCATAAGAAA
GTATCCGCCCGACAGGCCC -> TATCCGCCCGACAGGCCCT
ACAATGGGATACCCGAACC -> CAATGGGATACCCGAACCT
ATAGACTTCTCCTGAATGA -> TAGACTTCTCCTGAATGAG
CGAGGGATTGTCAGGCTAC -> GAGGGATTGTCAGGCTACC
TGTTAGAGAGTTATGATGC -> GTTAGAGAGTTATGATGCT
AGGTGGCAGGTCGGTGTAC -> GGTGGCAGGTCGGTGTACT
TAGTCAGTCCAGCAAAATA -> AGTCAGTCCAGCAAAATAG
AAAGTTCTACGAAGAAGTG -> AAGTTCTACGAAGAAGTGT
TTAGCACCTCCCACCTCTA -> TAGCACCTCCCACCTCTAC
TCCGTGATCAAATCCCTAA -> CCGTGATCAAATCCCTAAC
ATTCCTCGCCGGGGCGCTC -> TTCCTCGCCGGGGCGCTCC
TTGTTGTAAAGGTCTAAAC -> TGTTGTAAAGGTCTAAACT
GACATATGTCGCCACATTG -> ACATATGTCGCCACATTGG
AGACTTCTACGGTCGTACC -> GACTTCTACGGTCGTACCT
ATCAAGATTCATGCTCCCT -> TCAAGATTCATGCTCCCTT
AAAGCGCCGAGTCTTCCTA -> AAGCGCCGAGTCTTCCTAT
ATCCCAACGGAATTTGACA -> TCCCAACGGAATTTGACAG
AAGGCCTGCGCGAGTCGTC -> AGGCCTGCGCGAGTCGTCG
GCCAGGGGGAAGGCAGACT -> CCAGGGGGAAGGCAGACTC
GACAAGTACCCCATTTTGA -> ACAAGTACCCCATTTTGAC
GTTCTCATGCTGCAATCCG -> TTCTCATGCTGCAATCCGG
CAAAAGTTCTACGAAGAAG -> AAAAGTTCTACGAAGAAGT
GACAGGAGGACGCATTAAC -> ACAGGAGGACGCATTAACC
GCAGGTAAGGCCTGCGCGA -> CAGGTAAGGCCTGCGCGAG
AATTATCAGTGTTATAGGT -> ATTATCAGTGTTATAGGTG
TTTCCGTCCTCTCAAACCG -> TTCCGTCCTCTCAAACCGG
AACCGGTAACCAATCTAGT -> ACCGGTAACCAATCTAGTC
ACCGAAGTCTTTGTTAGTC -> CCGAAGTCTTTGTTAGTCC
GAACTGCAACCCGCCTAGC -> AACTGCAACCCGCCTAGCA
TAAACGCATCATATAGACT -> AAACGCATCATATAGACTT
GCCTGTGCCCCCGCCTGCG -> CCTGTGCCCCCGCCTGCGG
ACCTAGGGCCTGTGCCCCC -> CCTAGGGCCTGTGCCCCCG
CTAGGTTGTTGTAAAGGTC -> TAGGTTGTTGTAAAGGTCT
CATTCTGTAACCTGACTCA -> ATTCTGTAACCTGACTCAC
GAATCTGATGTGTGTGTGA -> AATCTGATGTGTGTGTGAT
CCGATGATCCGTAGTGCAC -> CGATGATCCGTAGTGCACT
TATTAGACTTGGCGCCTAG -> ATTAGACTTGGCGCCTAGG
ATGCTAGGCGCTGGAGTCT -> TGCTAGGCGCTGGAGTCTG
CAACGGAATTTGACAGTCC -> AACGGAATTTGACAGTCCC
GCCTGAATTGTCAGAGTAA -> CCTGAATTGTCAGAGTAAA
TAGGCCAATTGCCCGTTGT -> AGGCCAATTGCCCGTTGTT
GCCACTCCGTTTGTTGCAT -> CCACTCCGTTTGTTGCATA
GGGTCTATACAAACACGCG -> GGTCTATACAAACACGCGT
AGTCCAGCAAAATAGCATT -> GTCCAGCAAAATAGCATTG
ATCCCTAACCGGTATGTGT -> TCCCTAACCGGTATGTGTT
ATTCATAAGAAAAAGAGTA -> TTCATAAGAAAAAGAGTAC
TCGTAGTCGCAAGAACGAG -> CGTAGTCGCAAGAACGAGC
TCGCTTATATACGGTTATC -> CGCTTATATACGGTTATCA
GCGCTGGAGTCTGCTTTGC -> CGCTGGAGTCTGCTTTGCG
AATCCCTAACCGGTATGTG -> ATCCCTAACCGGTATGTGT
CGCCTAGAGTCGTGCCGAA -> GCCTAGAGTCGTGCCGAAC
GCCTATCGAATTCTAACTG -> CCTATCGAATTCTAACTGA
GGCCCTTGCAATTAGGATG -> GCCCTTGCAATTAGGATGA
TCAGTAACAAGGTTATGAC -> CAGTAACAAGGTTATGACG
GTGTGTGATTGAGCACGCG -> TGTGTGATTGAGCACGCGA
GTATACACTAACGAATCCA -> TATACACTAACGAATCCAA
TGAGTTCCACCAACGCATC -> GAGTTCCACCAACGCATCA
TCCGAGTGTTTCACCTTAG -> CCGAGTGTTTCACCTTAGG
TGGTGATGGAGAAATTCGA -> GGTGATGGAGAAATTCGAT
CGGCCTAACGCTATTTCCA -> GGCCTAACGCTATTTCCAT
TCATAAGAAAAAGAGTACC -> CATAAGAAAAAGAGTACCA
GTGAGGAACATCATTGACA -> TGAGGAACATCATTGACAA
TTCGAACTGCAACCCGCCT -> TCGAACTGCAACCCGCCTA
TCGAAGACTAGGTTGTTGT -> CGAAGACTAGGTTGTTGTA
GCTGTCACCAACGAGGGAT -> CTGTCACCAACGAGGGATT
GGAGCCATTGCAAATCCCT -> GAGCCATTGCAAATCCCTG
GCCAGTAAGAGCGACAGGA -> CCAGTAAGAGCGACAGGAG
TGCGCCAGTTGCCGATGAT -> GCGCCAGTTGCCGATGATC
AGCAATTACCTGATCTATA -> GCAATTACCTGATCTATAT
CTAGCATATTAGACTTGGC -> TAGCATATTAGACTTGGCG
CGAGTCCCGTCCCGGCGAG -> GAGTCCCGTCCCGGCGAGG
AGGCCCTTGCAATTAGGAT -> GGCCCTTGCAATTAGGATG
CCAGGAAAGATCTGTCAGT -> CAGGAAAGATCTGTCAGTT
ACATTGGCGCTGTAGAGGC -> CATTGGCGCTGTAGAGGCA
ACGTAGCACAATGGGATAC -> CGTAGCACAATGGGATACC
ATTGGCGCTGTAGAGGCAG -> TTGGCGCTGTAGAGGCAGT
GGATACCCGAACCTAGGGC -> GATACCCGAACCTAGGGCC
CGAACATAGTTCGGCCCTG -> GAACATAGTTCGGCCCTGA
TGACATATGTCGCCACATT -> GACATATGTCGCCACATTG
CTACACGTCGGTGATGATT -> TACACGTCGGTGATGATTA
CTCCGCGTGTAGTCATTAG -> TCCGCGTGTAGTCATTAGA
CACAAGTGAGGAAGCGGTA -> ACAAGTGAGGAAGCGGTAC
GAAATTCGATCTTAATTAT -> AAATTCGATCTTAATTATC
TCACGCCTGAATCGAGTAG -> CACGCCTGAATCGAGTAGC
TAACCTGACTCACGCCTGA -> AACCTGACTCACGCCTGAA
CTCGTGGTACCAACAACAA -> TCGTGGTACCAACAACAAA
CCAATTGCCCGTTGTTTGC -> CAATTGCCCGTTGTTTGCC
CTAACTTACGCATACCTTT -> TAACTTACGCATACCTTTG
GACTCAGAATGTGACGACT -> ACTCAGAATGTGACGACTG
CCACCTCTACTCATGAACA -> CACCTCTACTCATGAACAC
AGCGGGACGCATCATATAG -> GCGGGACGCATCATATAGA
TCGGTTACGACGTAGAGAT -> CGGTTACGACGTAGAGATC
GACGCATTAACCACGATTA -> ACGCATTAACCACGATTAG
TCCCAAATGAACGTCGCAT -> CCCAAATGAACGTCGCATT
CTGCCAGGGGGAAGGCAGA -> TGCCAGGGGGAAGGCAGAC
GTGACGACTGATCGAGCGC -> TGACGACTGATCGAGCGCC
ACGGTTATCATTAACCGGT -> CGGTTATCATTAACCGGTA
ATGTGACGACTGATCGAGC -> TGTGACGACTGATCGAGCG
GTCAGTCCAGCAAAATAGC -> TCAGTCCAGCAAAATAGCA
CGGAGCCATTGCAAATCCC -> GGAGCCATTGCAAATCCCT
TTGCCGATGATCCGTAGTG -> TGCCGATGATCCGTAGTGC
TAAAGGTCTAAACTGAGGC -> AAAGGTCTAAACTGAGGCC
TGTGTGATTGAGCACGCGA -> GTGTGATTGAGCACGCGAC
TGTTTCGCGATTCACGCAG -> GTTTCGCGATTCACGCAGC
CGATGCGCTACTGACCTTC -> GATGCGCTACTGACCTTCT
AATTTGACAGTCCCGGCGT -> ATTTGACAGTCCCGGCGTG
GTAGAGATCCCAAATGAAC -> TAGAGATCCCAAATGAACG
CGACAGGAGGACGCATTAA -> GACAGGAGGACGCATTAAC
CTAGGGACAAGTACCCCAT -> TAGGGACAAGTACCCCATT
CTTTGTTAGTCCTATGAGC -> TTTGTTAGTCCTATGAGCG
GATGCGCTACTGACCTTCT -> ATGCGCTACTGACCTTCTT
ATATAGACTTCTCCTACGC -> TATAGACTTCTCCTACGCA
AACATCATTGACAATTTGC -> ACATCATTGACAATTTGCT
TCTATATTATTCCTCGCCG -> CTATATTATTCCTCGCCGG
TGCCTGTTTCGCGATTCAC -> GCCTGTTTCGCGATTCACG
TAGAGGCAGTCATCTAAGC -> AGAGGCAGTCATCTAAGCT
CTGACTCACGCCTGAATAC -> TGACTCACGCCTGAATACA
AGCTTGTGTCCCCGCCCTG -> GCTTGTGTCCCCGCCCTGG
TTACTCTGTCAACTGCGGG -> TACTCTGTCAACTGCGGGG
TGAGGCCTCACTAACTTAC -> GAGGCCTCACTAACTTACG
GTTTCACCTTAGGTCTTAG -> TTTCACCTTAGGTCTTAGC
ACGAGGGATTGTCAGGCTA -> CGAGGGATTGTCAGGCTAC
TTGGTGATGGAGAAATTCG -> TGGTGATGGAGAAATTCGA
TCATTAGATCGTAGTCGCA -> CATTAGATCGTAGTCGCAA
GAACACAAGTGAGGAAGCG -> AACACAAGTGAGGAAGCGG
ACGGCCTAACGCTATTTCC -> CGGCCTAACGCTATTTCCA
ATCCCCACTTCGAACTGCA -> TCCCCACTTCGAACTGCAA
AGAGATCCCAAATGAACGT -> GAGATCCCAAATGAACGTC
GACAGTCCCGGCGTGGCGT -> ACAGTCCCGGCGTGGCGTT
ACAGAGTTGGTACCTGTCT -> CAGAGTTGGTACCTGTCTG
GCTTGCGCCAGTTGCCGAT -> CTTGCGCCAGTTGCCGATG
GGCAATGCCTGTTTCGCGA -> GCAATGCCTGTTTCGCGAT
TCAGTCCAGCAAAATAGCA -> CAGTCCAGCAAAATAGCAT
AATCTCGTCAGATTCATCT -> ATCTCGTCAGATTCATCTA
TTTTATAGGATGTAAGCTT -> TTTATAGGATGTAAGCTTG
CAAGCCACTCCGTTTGTTG -> AAGCCACTCCGTTTGTTGC
TTCTGTAACCTGACTCACG -> TCTGTAACCTGACTCACGC
CTACGGTCGTACCTCCGCG -> TACGGTCGTACCTCCGCGT
ATGCGCTACTGACCTTCTT -> TGCGCTACTGACCTTCTTT
ATGGACTGTCCGTCTCTAG -> TGGACTGTCCGTCTCTAGA
ATCGAGTAGCGGGACGCAT -> TCGAGTAGCGGGACGCATC
CAATGGGATACCCGAACCT -> AATGGGATACCCGAACCTA
CAATCTAGTCTCGGTGGGT -> AATCTAGTCTCGGTGGGTA
GAGGACGCATTAACCACGA -> AGGACGCATTAACCACGAT
TTCAGCATCGGTTACGACG -> TCAGCATCGGTTACGACGT
GAAGGATAGCTAGTTGTTA -> AAGGATAGCTAGTTGTTAC
GTCTGCTTTGCGGAGCCAT -> TCTGCTTTGCGGAGCCATT
GAATTCTAACTGAAATCCC -> AATTCTAACTGAAATCCCA
TCGGGCTGTCACCAACGAG -> CGGGCTGTCACCAACGAGG
TCGAACTGGTTTCCGTCCT -> CGAACTGGTTTCCGTCCTC
ACAGGCCCTTGCAATTAGG -> CAGGCCCTTGCAATTAGGA
GGAAGGCAGACTCAGAATG -> GAAGGCAGACTCAGAATGT
AGCAAATACTCCGGTGAGG -> GCAAATACTCCGGTGAGGA
CCGCCTGCGGTGAGACCCA -> CGCCTGCGGTGAGACCCAT
CCACTACCTTTTTATAGGA -> CACTACCTTTTTATAGGAT
CTTATATACGGTTATCATT -> TTATATACGGTTATCATTA
TTTCCCGCCGTAAGCGAAA -> TTCCCGCCGTAAGCGAAAA
CCTAGCATATTAGACTTGG -> CTAGCATATTAGACTTGGC
AGGATAGCTAGTTGTTACG -> GGATAGCTAGTTGTTACGG
ACAATTTGCTAGCTTAGCA -> CAATTTGCTAGCTTAGCAC
GCGTGGCGTTCAGCATCGG -> CGTGGCGTTCAGCATCGGT
TGTTCTCATGCTGCAATCC -> GTTCTCATGCTGCAATCCG
GTTTCCCGCCGTAAGCGAA -> TTTCCCGCCGTAAGCGAAA
ATTAGGATGATAAGACAAT -> TTAGGATGATAAGACAATG
ATTTCTGGACCGCCTAGAG -> TTTCTGGACCGCCTAGAGT
GCATATTAGACTTGGCGCC -> CATATTAGACTTGGCGCCT
GTAACCAATCTAGTCTCGG -> TAACCAATCTAGTCTCGGT
TCTTCCTATCGATAAGCAC -> CTTCCTATCGATAAGCACG
CAACAAAGCGCCGAGTCTT -> AACAAAGCGCCGAGTCTTC
ATAGACTTCTCCTACGCAT -> TAGACTTCTCCTACGCATC
ATGAGTTCCACCAACGCAT -> TGAGTTCCACCAACGCATC
CTGAAATCCCAACGGAATT -> TGAAATCCCAACGGAATTT
CTCCCACCTCTACTCATGA -> TCCCACCTCTACTCATGAA
GACTCACGCCTGAATTGTC -> ACTCACGCCTGAATTGTCA
GTCTCTAGATCAAGATTCA -> TCTCTAGATCAAGATTCAT
AACCAGGAAAGATCTGTCA -> ACCAGGAAAGATCTGTCAG
TATAGACTTCTCCTACGCA -> ATAGACTTCTCCTACGCAT
AACATAGTTCGGCCCTGAC -> ACATAGTTCGGCCCTGACT
TCTCGTCAGATTCATCTAG -> CTCGTCAGATTCATCTAGG
TTCCATGGAGATACTGATC -> TCCATGGAGATACTGATCA
GATTCACGCAGCAAATACT -> ATTCACGCAGCAAATACTC
GCGACAGGAGGACGCATTA -> CGACAGGAGGACGCATTAA
TGGTACCTGTCTGTTCTCA -> GGTACCTGTCTGTTCTCAT
TTGTGTCCCCGCCCTGGTA -> TGTGTCCCCGCCCTGGTAT
GTGGAATTTCACTACACGT -> TGGAATTTCACTACACGTC
AGTCATCTAAGCTTGTGTC -> GTCATCTAAGCTTGTGTCC
ACGGTCGTACCTCCGCGTG -> CGGTCGTACCTCCGCGTGT
TAACGCTATTTCCATGGAG -> AACGCTATTTCCATGGAGA
GGAAATCGCTTGGGGGGTC -> GAAATCGCTTGGGGGGTCC
CATGAACACCGCTTCAAGA -> ATGAACACCGCTTCAAGAT
GCTTGTATCCGCCCGACAG -> CTTGTATCCGCCCGACAGG
GGGGTCCTCTCACCTGCCA -> GGGTCCTCTCACCTGCCAG
CATCATTGACAATTTGCTA -> ATCATTGACAATTTGCTAG
TCAAGATATCGAGTCCCGT -> CAAGATATCGAGTCCCGTC
GCAGGGTGGAATTTCACTA -> CAGGGTGGAATTTCACTAC
GAAAACCCGGATTAACCAG -> AAAACCCGGATTAACCAGG
ACGAAGAAGTGTTCTCCGT -> CGAAGAAGTGTTCTCCGTG
CCGCCCGACAGGCCCTTGC -> CGCCCGACAGGCCCTTGCA
ACGCAGCAAATACTCCGGT -> CGCAGCAAATACTCCGGTG
CACCCCAAGCCACTCCGTT -> ACCCCAAGCCACTCCGTTT
TTAGCCAGTAGGCAGGTAA -> TAGCCAGTAGGCAGGTAAG
TAGACTTCTGAATCTGATG -> AGACTTCTGAATCTGATGT
TGTAAAGGTCTAAACTGAG -> GTAAAGGTCTAAACTGAGG
AGAGGCAGTCATCTAAGCT -> GAGGCAGTCATCTAAGCTT
CCGAACCTAGGGCCTGTGC -> CGAACCTAGGGCCTGTGCC
GACGTAGAGATCCCAAATG -> ACGTAGAGATCCCAAATGA
TAACCAGGAAAGATCTGTC -> AACCAGGAAAGATCTGTCA
CGGGGTCTATACAAACACG -> GGGGTCTATACAAACACGC
AAGGACCCTATCGCTTGCG -> AGGACCCTATCGCTTGCGC
AAATACTCCGGTGAGGAAC -> AATACTCCGGTGAGGAACA
GATGATCCGTAGTGCACTC -> ATGATCCGTAGTGCACTCG
AGCCACTCCGTTTGTTGCA -> GCCACTCCGTTTGTTGCAT
GATCTTAATTATCAGTGTT -> ATCTTAATTATCAGTGTTA
TTCTCCTGAATGAGTTCCA -> TCTCCTGAATGAGTTCCAC
TAGCTTAGCACCTCCCACC -> AGCTTAGCACCTCCCACCT
CTGTCTGTTCTCATGCTGC -> TGTCTGTTCTCATGCTGCA
CAAGTACCCCATTTTGACA -> AAGTACCCCATTTTGACAT
AGATCTGTCAGTTAGTCAG -> GATCTGTCAGTTAGTCAGT
TAGGGACAAGTACCCCATT -> AGGGACAAGTACCCCATTT
TGGGATACCCGAACCTAGG -> GGGATACCCGAACCTAGGG
CATCGGGCTGTCACCAACG -> ATCGGGCTGTCACCAACGA
ACAAACACGCGTAGTTACC -> CAAACACGCGTAGTTACCC
TAACTTACGCATACCTTTG -> AACTTACGCATACCTTTGG
AATCGAGTAGCGGGACGCA -> ATCGAGTAGCGGGACGCAT
GTCCCCGCCCTGGTATACA -> TCCCCGCCCTGGTATACAC
CTCACGCCTGAATTGTCAG -> TCACGCCTGAATTGTCAGA
CTGACTCACGCCTGAATCG -> TGACTCACGCCTGAATCGA
ACTCCGTTTGTTGCATAAC -> CTCCGTTTGTTGCATAACT
GGCAGGTAAGGCCTGCGCG -> GCAGGTAAGGCCTGCGCGA
AAGGGGCGCGCGAAGGATA -> AGGGGCGCGCGAAGGATAG
CGTGATCAAATCCCTAACC -> GTGATCAAATCCCTAACCG
TCCATGGAGATACTGATCA -> CCATGGAGATACTGATCAC
ACCTCTACTCATGAACACC -> CCTCTACTCATGAACACCG
GGGCCTGTGCCCCCGCCTG -> GGCCTGTGCCCCCGCCTGC
TCGTCGAACTGGTTTCCGT -> CGTCGAACTGGTTTCCGTC
TCTGTAACCTGACTCACGC -> CTGTAACCTGACTCACGCC
AGGACCCTATCGCTTGCGC -> GGACCCTATCGCTTGCGCC
AGTCTTCCTATCGATAAGC -> GTCTTCCTATCGATAAGCA
TTAGGATGATAAGACAATG -> TAGGATGATAAGACAATGC
CGAAGAAGTGTTCTCCGTG -> GAAGAAGTGTTCTCCGTGA
GTTAGTCAGTCCAGCAAAA -> TTAGTCAGTCCAGCAAAAT
CATAGTTCGGCCCTGACTA -> ATAGTTCGGCCCTGACTAC
CCCCCGCCTGCGGTGAGAC -> CCCCGCCTGCGGTGAGACC
CCTACGCATCATATAGACT -> CTACGCATCATATAGACTT
CTTGTGTCCCCGCCCTGGT -> TTGTGTCCCCGCCCTGGTA
GCCAGTAGGCAGGTAAGGC -> CCAGTAGGCAGGTAAGGCC
GTGCCGAACATAGTTCGGC -> TGCCGAACATAGTTCGGCC
CGTCGCATTCATAAGAAAA -> GTCGCATTCATAAGAAAAA
GTCGGGTCTAGGGACAAGT -> TCGGGTCTAGGGACAAGTA
TTACCTGATCTATATTATT -> TACCTGATCTATATTATTC
AAGAGCGACAGGAGGACGC -> AGAGCGACAGGAGGACGCA
ACTTGGCGCCTAGGCAATG -> CTTGGCGCCTAGGCAATGC
TATAGACTTCTCCTGAATG -> ATAGACTTCTCCTGAATGA
ATCGGGCTGTCACCAACGA -> TCGGGCTGTCACCAACGAG
TTAGCAATTACCTGATCTA -> TAGCAATTACCTGATCTAT
CACGCCACTACCTTTTTAT -> ACGCCACTACCTTTTTATA
ACAGTCCCGGCGTGGCGTT -> CAGTCCCGGCGTGGCGTTC
TTACGGCTTCATACCCCTG -> TACGGCTTCATACCCCTGA
ATAGGATGTAAGCTTGTAT -> TAGGATGTAAGCTTGTATC
CCAAATGAACGTCGCATTC -> CAAATGAACGTCGCATTCA
ATATACGGTTATCATTAAC -> TATACGGTTATCATTAACC
GTCACCAACGAGGGATTGT -> TCACCAACGAGGGATTGTC
TGCAATCTCGTCAGATTCA -> GCAATCTCGTCAGATTCAT
AGGCAGTCATCTAAGCTTG -> GGCAGTCATCTAAGCTTGT
GAGCACGCGACCGGTAAAA -> AGCACGCGACCGGTAAAAG
AGCTGGCCTATCGAATTCT -> GCTGGCCTATCGAATTCTA
CCGTTTGTTGCATAACTCA -> CGTTTGTTGCATAACTCAT
TGAAATCCCAACGGAATTT -> GAAATCCCAACGGAATTTG
CGAAGTCTTTGTTAGTCCT -> GAAGTCTTTGTTAGTCCTA
GGCCTGACTCACGTCCTGA -> GCCTGACTCACGTCCTGAC
CATAATCCCCACTTCGAAC -> ATAATCCCCACTTCGAACT
GGACGCATTAACCACGATT -> GACGCATTAACCACGATTA
AACCGATTCTCTGAGCACC -> ACCGATTCTCTGAGCACCG
ACCCGAACCTAGGGCCTGT -> CCCGAACCTAGGGCCTGTG
TTTACGGCTTCATACCCCT -> TTACGGCTTCATACCCCTG
TGGCCTATCGAATTCTAAC -> GGCCTATCGAATTCTAACT
AATCCCAACGGAATTTGAC -> ATCCCAACGGAATTTGACA
GGAGTCTGCTTTGCGGAGC -> GAGTCTGCTTTGCGGAGCC
GCGGTACGTGTGAGTTGGA -> CGGTACGTGTGAGTTGGAC
GTTGGACAGGGGCGCAGGG -> TTGGACAGGGGCGCAGGGT
CGTAAGCGAAAACCCGGAT -> GTAAGCGAAAACCCGGATT
CCTTACATTGTTAGAGAGT -> CTTACATTGTTAGAGAGTT
ATCGCTTGGGGGGTCCTCT -> TCGCTTGGGGGGTCCTCTC
TACCTTTGGAGAGATATCA -> ACCTTTGGAGAGATATCAA
GACTGATCGAGCGCCATCA -> ACTGATCGAGCGCCATCAG
CAAGTGAGGAAGCGGTACG -> AAGTGAGGAAGCGGTACGT
GCATAACTCATCGAAGACT -> CATAACTCATCGAAGACTA
GTGTTCTCCGTGATCAAAT -> TGTTCTCCGTGATCAAATC
GAGTTGGACAGGGGCGCAG -> AGTTGGACAGGGGCGCAGG
GGGGAAATCGCTTGGGGGG -> GGGAAATCGCTTGGGGGGT
CGGGACGCATCATATAGAC -> GGGACGCATCATATAGACT
TATACGGTTATCATTAACC -> ATACGGTTATCATTAACCG
GTTCTCCGTGATCAAATCC -> TTCTCCGTGATCAAATCCC
AATACATGTCGGCCTGACT -> ATACATGTCGGCCTGACTC
CTAAACTGAGGCCTCACTA -> TAAACTGAGGCCTCACTAA
TCCGTCTCTAGATCAAGAT -> CCGTCTCTAGATCAAGATT
ACCGGTAACCAATCTAGTC -> CCGGTAACCAATCTAGTCT
AGGATGTAAGCTTGTATCC -> GGATGTAAGCTTGTATCCG
CATATAGACTTCTCCTACG -> ATATAGACTTCTCCTACGC
AGTAGCGGGACGCATCATA -> GTAGCGGGACGCATCATAT
TCTTTGATATCGCTTATAT -> CTTTGATATCGCTTATATA
AACGAGCGGATGGACTGTC -> ACGAGCGGATGGACTGTCC
TTCATGCTCCCTTCCAATC -> TCATGCTCCCTTCCAATCC
CACTTCGAACTGCAACCCG -> ACTTCGAACTGCAACCCGC
CCTATGAGCGAAAAGGACC -> CTATGAGCGAAAAGGACCC
CCTGAATCGAGTAGCGGGA -> CTGAATCGAGTAGCGGGAC
CTGTTCTCATGCTGCAATC -> TGTTCTCATGCTGCAATCC
TGCTAAATGGTCGGGTCTA -> GCTAAATGGTCGGGTCTAG
TATCGCTTATATACGGTTA -> ATCGCTTATATACGGTTAT
AGTCGTGCCGAACATAGTT -> GTCGTGCCGAACATAGTTC
CAAACCGGGGTCTATACAA -> AAACCGGGGTCTATACAAA
AATAGCATTGGTGATGGAG -> ATAGCATTGGTGATGGAGA
CGGTTACGACGTAGAGATC -> GGTTACGACGTAGAGATCC
AACCCGCCTAGCATATTAG -> ACCCGCCTAGCATATTAGA
CGGAGCGCTTACTCTGTCA -> GGAGCGCTTACTCTGTCAA
GCGAAAACCCGGATTAACC -> CGAAAACCCGGATTAACCA
AATGAGTTCCACCAACGCA -> ATGAGTTCCACCAACGCAT
CTGGTATACACTAACGAAT -> TGGTATACACTAACGAATC
TATATACGGTTATCATTAA -> ATATACGGTTATCATTAAC
GCTGCAATCCGGAGAGCCA -> CTGCAATCCGGAGAGCCAT
CCTGTGCCCCCGCCTGCGG -> CTGTGCCCCCGCCTGCGGT
CTGAAGCTCAAGAACACAA -> TGAAGCTCAAGAACACAAG
AGAATCTGGCCTCTTTGAT -> GAATCTGGCCTCTTTGATA
ACGCGACCGGTAAAAGCTG -> CGCGACCGGTAAAAGCTGG
CGAACCTAGGGCCTGTGCC -> GAACCTAGGGCCTGTGCCC
ACTGTCCGTCTCTAGATCA -> CTGTCCGTCTCTAGATCAA
CATGAGTGAGCTGGCCTAT -> ATGAGTGAGCTGGCCTATC
GATCCGTAGTGCACTCGTG -> ATCCGTAGTGCACTCGTGG
CTCCGTTTGTTGCATAACT -> TCCGTTTGTTGCATAACTC
CTTACGCATACCTTTGGAG -> TTACGCATACCTTTGGAGA
GCCACATTGGCGCTGTAGA -> CCACATTGGCGCTGTAGAG
CCCCAAGCCACTCCGTTTG -> CCCAAGCCACTCCGTTTGT
CCACGGCCTAACGCTATTT -> CACGGCCTAACGCTATTTC
GGCGCGCGAAGGATAGCTA -> GCGCGCGAAGGATAGCTAG
ACACTAACGAATCCAAAAG -> CACTAACGAATCCAAAAGT
CGATCTTAATTATCAGTGT -> GATCTTAATTATCAGTGTT
TCTCATGCTGCAATCCGGA -> CTCATGCTGCAATCCGGAG
AAGGTTATGACGTAGCACA -> AGGTTATGACGTAGCACAA
CACGATTAGCCAGTAGGCA -> ACGATTAGCCAGTAGGCAG
ATTATTCCTCGCCGGGGCG -> TTATTCCTCGCCGGGGCGC
ATGCAATCTCGTCAGATTC -> TGCAATCTCGTCAGATTCA
GGCCTGTGCCCCCGCCTGC -> GCCTGTGCCCCCGCCTGCG
TTGAGCACGCGACCGGTAA -> TGAGCACGCGACCGGTAAA
CGCGACCGGTAAAAGCTGG -> GCGACCGGTAAAAGCTGGT
CCATCGGGCTGTCACCAAC -> CATCGGGCTGTCACCAACG
GAGGAAGCGGTACGTGTGA -> AGGAAGCGGTACGTGTGAG
GCCACTACCTTTTTATAGG -> CCACTACCTTTTTATAGGA
GACAATTTGCTAGCTTAGC -> ACAATTTGCTAGCTTAGCA
GGCTACCGAAGTCTTTGTT -> GCTACCGAAGTCTTTGTTA
AGAAGTGTTCTCCGTGATC -> GAAGTGTTCTCCGTGATCA
TCTAAGCTTGTGTCCCCGC -> CTAAGCTTGTGTCCCCGCC
TCGATAAGCACGGCGATGC -> CGATAAGCACGGCGATGCG
TGTGACGACTGATCGAGCG -> GTGACGACTGATCGAGCGC
TGGGGGGTCCTCTCACCTG -> GGGGGGTCCTCTCACCTGC
AATTCGATCTTAATTATCA -> ATTCGATCTTAATTATCAG
CCCAAGCCACTCCGTTTGT -> CCAAGCCACTCCGTTTGTT
TATAGGATGTAAGCTTGTA -> ATAGGATGTAAGCTTGTAT
CGCAGGGTGGAATTTCACT -> GCAGGGTGGAATTTCACTA
ACCAATCTAGTCTCGGTGG -> CCAATCTAGTCTCGGTGGG
GTGAGTTGGACAGGGGCGC -> TGAGTTGGACAGGGGCGCA
TAGCATTGGTGATGGAGAA -> AGCATTGGTGATGGAGAAA
CCAGTAGGCAGGTAAGGCC -> CAGTAGGCAGGTAAGGCCT
GCACCTCCCACCTCTACTC -> CACCTCCCACCTCTACTCA
ATACGGTTATCATTAACCG -> TACGGTTATCATTAACCGG
GACGACTGATCGAGCGCCA -> ACGACTGATCGAGCGCCAT
CACTCATGAGTGAGCTGGC -> ACTCATGAGTGAGCTGGCC
CTGAGCACCGTTGATGCAA -> TGAGCACCGTTGATGCAAT
TCGGCCTGACTCACGTCCT -> CGGCCTGACTCACGTCCTG
CTTCAAGATATCGAGTCCC -> TTCAAGATATCGAGTCCCG
CTCGGTGGGTATTCCACTG -> TCGGTGGGTATTCCACTGT
GAGTAAACGCATCATATAG -> AGTAAACGCATCATATAGA
CTGTCACCAACGAGGGATT -> TGTCACCAACGAGGGATTG
CCAACGCATCATATAGACT -> CAACGCATCATATAGACTT
TAGTCCTATGAGCGAAAAG -> AGTCCTATGAGCGAAAAGG
GGGGGTCCTCTCACCTGCC -> GGGGTCCTCTCACCTGCCA
TTGACAGTCCCGGCGTGGC -> TGACAGTCCCGGCGTGGCG
TGCTAGGCGCTGGAGTCTG -> GCTAGGCGCTGGAGTCTGC
TGCCCCCGCCTGCGGTGAG -> GCCCCCGCCTGCGGTGAGA
AACTGGTTTCCGTCCTCTC -> ACTGGTTTCCGTCCTCTCA
GTACCACCCCAAGCCACTC -> TACCACCCCAAGCCACTCC
GCCTAGCATATTAGACTTG -> CCTAGCATATTAGACTTGG
GATGCAATCTCGTCAGATT -> ATGCAATCTCGTCAGATTC
TCATTAACCGGTAACCAAT -> CATTAACCGGTAACCAATC
TGTGCCCCCGCCTGCGGTG -> GTGCCCCCGCCTGCGGTGA
TCCCTAACCGGTATGTGTT -> CCCTAACCGGTATGTGTTA
AGAGTTGGTACCTGTCTGT -> GAGTTGGTACCTGTCTGTT
TCACAGAGTTGGTACCTGT -> CACAGAGTTGGTACCTGTC
TTTGCCAGTAAGAGCGACA -> TTGCCAGTAAGAGCGACAG
GCTTCAAGATATCGAGTCC -> CTTCAAGATATCGAGTCCC
CCCGGATTAACCAGGAAAG -> CCGGATTAACCAGGAAAGA
CTTTGCGGAGCCATTGCAA -> TTTGCGGAGCCATTGCAAA
CTAGGCCAATTGCCCGTTG -> TAGGCCAATTGCCCGTTGT
AGTTCCACCAACGCATCAT -> GTTCCACCAACGCATCATA
TCGCCACATTGGCGCTGTA -> CGCCACATTGGCGCTGTAG
TTCATAAGAAAAAGAGTAC -> TCATAAGAAAAAGAGTACC
CAGTTAGTCAGTCCAGCAA -> AGTTAGTCAGTCCAGCAAA
CGACGTAGAGATCCCAAAT -> GACGTAGAGATCCCAAATG
CTTACTCTGTCAACTGCGG -> TTACTCTGTCAACTGCGGG
CGCGTAGTTACCCAGAATC -> GCGTAGTTACCCAGAATCT
GATCTGTCAGTTAGTCAGT -> ATCTGTCAGTTAGTCAGTC
TCCTGAATGAGTTCCACCA -> CCTGAATGAGTTCCACCAA
CATCGAAGACTAGGTTGTT -> ATCGAAGACTAGGTTGTTG
AGTGTTATAGGTGGCAGGT -> GTGTTATAGGTGGCAGGTC
GCATCATATAGACTTCTGA -> CATCATATAGACTTCTGAA
GTCCGGTACCACCCCAAGC -> TCCGGTACCACCCCAAGCC
GGGACGCATCATATAGACT -> GGACGCATCATATAGACTT
CGTGTGAGTTGGACAGGGG -> GTGTGAGTTGGACAGGGGC
GTGATTGAGCACGCGACCG -> TGATTGAGCACGCGACCGG
TTGCGCCAGTTGCCGATGA -> TGCGCCAGTTGCCGATGAT
AATACTCCGGTGAGGAACA -> ATACTCCGGTGAGGAACAT
AGCACCGTTGATGCAATCT -> GCACCGTTGATGCAATCTC
ATGTGTTACATAATCCCCA -> TGTGTTACATAATCCCCAC
GTTATGACGTAGCACAATG -> TTATGACGTAGCACAATGG
TAAGAAAAAGAGTACCACG -> AAGAAAAAGAGTACCACGG
TCAACTGCGGGGAAATCGC -> CAACTGCGGGGAAATCGCT
CTGTAGAGGCAGTCATCTA -> TGTAGAGGCAGTCATCTAA
ATCATATAGACTTCTCCTG -> TCATATAGACTTCTCCTGA
ACTTCTCCTGAATGAGTTC -> CTTCTCCTGAATGAGTTCC
TATAGACTTCTGAATCTGA -> ATAGACTTCTGAATCTGAT
ACTGCGGGGAAATCGCTTG -> CTGCGGGGAAATCGCTTGG
TACATTGTTAGAGAGTTAT -> ACATTGTTAGAGAGTTATG
CCTAGAGTCGTGCCGAACA -> CTAGAGTCGTGCCGAACAT
TTTGTTGCATAACTCATCG -> TTGTTGCATAACTCATCGA
GTTTCCGTCCTCTCAAACC -> TTTCCGTCCTCTCAAACCG
ATTGAGCACGCGACCGGTA -> TTGAGCACGCGACCGGTAA
GGTCCTCTCACCTGCCAGG -> GTCCTCTCACCTGCCAGGG
ACCGATTCTCTGAGCACCG -> CCGATTCTCTGAGCACCGT
TCATCGAAGACTAGGTTGT -> CATCGAAGACTAGGTTGTT
GCTACCGAAGTCTTTGTTA -> CTACCGAAGTCTTTGTTAG
CATTGACAATTTGCTAGCT -> ATTGACAATTTGCTAGCTT
AACCCGGATTAACCAGGAA -> ACCCGGATTAACCAGGAAA
TCCCGGCGTGGCGTTCAGC -> CCCGGCGTGGCGTTCAGCA
GTGAGACCCATCGGGCTGT -> TGAGACCCATCGGGCTGTC
TGTGATTGAGCACGCGACC -> GTGATTGAGCACGCGACCG
CGGCGTGGCGTTCAGCATC -> GGCGTGGCGTTCAGCATCG
CGCTTACTCTGTCAACTGC -> GCTTACTCTGTCAACTGCG
ATCAGTAACAAGGTTATGA -> TCAGTAACAAGGTTATGAC
TATAGACTTCTACGGTCGT -> ATAGACTTCTACGGTCGTA
CATTTTGACATATGTCGCC -> ATTTTGACATATGTCGCCA
ACCAACGCATCATATAGAC -> CCAACGCATCATATAGACT
CCTGAATACATGTCGGCCT -> CTGAATACATGTCGGCCTG
CTTGTATCCGCCCGACAGG -> TTGTATCCGCCCGACAGGC
TTCAAGATATCGAGTCCCG -> TCAAGATATCGAGTCCCGT
TCTTAATTATCAGTGTTAT -> CTTAATTATCAGTGTTATA
GATTTCTGGACCGCCTAGA -> ATTTCTGGACCGCCTAGAG
TAGGCGCTGGAGTCTGCTT -> AGGCGCTGGAGTCTGCTTT
CGAGTAGCGGGACGCATCA -> GAGTAGCGGGACGCATCAT
TCAGAGTAAACGCATCATA -> CAGAGTAAACGCATCATAT
GAGTCGTGCCGAACATAGT -> AGTCGTGCCGAACATAGTT
GTCGCCACATTGGCGCTGT -> TCGCCACATTGGCGCTGTA
GTGTACTGTCACGCCACTA -> TGTACTGTCACGCCACTAC
CCTTTTTATAGGATGTAAG -> CTTTTTATAGGATGTAAGC
CCACTTCGAACTGCAACCC -> CACTTCGAACTGCAACCCG
CCAACAACAAAGCGCCGAG -> CAACAACAAAGCGCCGAGT
ACTTCGAACTGCAACCCGC -> CTTCGAACTGCAACCCGCC
CAGTCCAGCAAAATAGCAT -> AGTCCAGCAAAATAGCATT
TATCAGTGTTATAGGTGGC -> ATCAGTGTTATAGGTGGCA
GACTAGGTTGTTGTAAAGG -> ACTAGGTTGTTGTAAAGGT
CTTCTGAATCTGATGTGTG -> TTCTGAATCTGATGTGTGT
CCATTGCAAATCCCTGACT -> CATTGCAAATCCCTGACTC
CCTGAATTGTCAGAGTAAA -> CTGAATTGTCAGAGTAAAC
GAGGAACATCATTGACAAT -> AGGAACATCATTGACAATT
TGAGTTGGACAGGGGCGCA -> GAGTTGGACAGGGGCGCAG
ATCTGTCAGTTAGTCAGTC -> TCTGTCAGTTAGTCAGTCC
CTGAATCTGATGTGTGTGT -> TGAATCTGATGTGTGTGTG
AGTAACAAGGTTATGACGT -> GTAACAAGGTTATGACGTA
TATCCGCCCGACAGGCCCT -> ATCCGCCCGACAGGCCCTT
CTGTAACCTGACTCACGCC -> TGTAACCTGACTCACGCCT
ATTCATCTAGGCCAATTGC -> TTCATCTAGGCCAATTGCC
AGACCCATCGGGCTGTCAC -> GACCCATCGGGCTGTCACC
ACTCCGGTGAGGAACATCA -> CTCCGGTGAGGAACATCAT
CACCAACGCATCATATAGA -> ACCAACGCATCATATAGAC
GCTAGCTTAGCACCTCCCA -> CTAGCTTAGCACCTCCCAC
TTCCTATCGATAAGCACGG -> TCCTATCGATAAGCACGGC
ATCATTAACCGGTAACCAA -> TCATTAACCGGTAACCAAT
CCTGACTCACGCCTGAATA -> CTGACTCACGCCTGAATAC
CACGTCCTGACTCACGCCT -> ACGTCCTGACTCACGCCTG
TCTGGACCGCCTAGAGTCG -> CTGGACCGCCTAGAGTCGT
CCTTTGGAGAGATATCAAG -> CTTTGGAGAGATATCAAGG
TACGGAGCGCTTACTCTGT -> ACGGAGCGCTTACTCTGTC
TGCGCGAGTCGTCGAACTG -> GCGCGAGTCGTCGAACTGG
TTTGACAGTCCCGGCGTGG -> TTGACAGTCCCGGCGTGGC
GAAAAAGAGTACCACGGCC -> AAAAAGAGTACCACGGCCT
ATAGACTTCTACGGTCGTA -> TAGACTTCTACGGTCGTAC
ATTTCCATGGAGATACTGA -> TTTCCATGGAGATACTGAT
GGTGGGTATTCCACTGTTA -> GTGGGTATTCCACTGTTAG
CCCGACAGGCCCTTGCAAT -> CCGACAGGCCCTTGCAATT
CTGAATACATGTCGGCCTG -> TGAATACATGTCGGCCTGA
AGCATTGGTGATGGAGAAA -> GCATTGGTGATGGAGAAAT
GCCCGACAGGCCCTTGCAA -> CCCGACAGGCCCTTGCAAT
GAATCTGGCCTCTTTGATA -> AATCTGGCCTCTTTGATAT
ATTGTTAGAGAGTTATGAT -> TTGTTAGAGAGTTATGATG
TCTCACCTGCCAGGGGGAA -> CTCACCTGCCAGGGGGAAG
CCGCCGTAAGCGAAAACCC -> CGCCGTAAGCGAAAACCCG
TCACTCATGAGTGAGCTGG -> CACTCATGAGTGAGCTGGC
CGCTTATATACGGTTATCA -> GCTTATATACGGTTATCAT
TCCTCTCACCTGCCAGGGG -> CCTCTCACCTGCCAGGGGG
ACTACCTTTTTATAGGATG -> CTACCTTTTTATAGGATGT
ATGTCGGCCTGACTCACGT -> TGTCGGCCTGACTCACGTC
GTTGTTTGCCAGTAAGAGC -> TTGTTTGCCAGTAAGAGCG
CTAACGAATCCAAAAGTTC -> TAACGAATCCAAAAGTTCT
AGCGCCATCAGTAACAAGG -> GCGCCATCAGTAACAAGGT
TTGGAGAGATATCAAGGGG -> TGGAGAGATATCAAGGGGC
AACCGGTATGTGTTACATA -> ACCGGTATGTGTTACATAA
CAGTGTTATAGGTGGCAGG -> AGTGTTATAGGTGGCAGGT
ATACACTAACGAATCCAAA -> TACACTAACGAATCCAAAA
AGGAAAGATCTGTCAGTTA -> GGAAAGATCTGTCAGTTAG
ACAGGAGGACGCATTAACC -> CAGGAGGACGCATTAACCA
TGCAATCCGGAGAGCCATT -> GCAATCCGGAGAGCCATTC
GGCGCAGGGTGGAATTTCA -> GCGCAGGGTGGAATTTCAC
GAATTGTCAGAGTAAACGC -> AATTGTCAGAGTAAACGCA
ACATAGTTCGGCCCTGACT -> CATAGTTCGGCCCTGACTA
AGCTAGTTGTTACGGAGCG -> GCTAGTTGTTACGGAGCGC
CATGGAGATACTGATCACA -> ATGGAGATACTGATCACAG
GTCTAAACTGAGGCCTCAC -> TCTAAACTGAGGCCTCACT
TTGCAATTAGGATGATAAG -> TGCAATTAGGATGATAAGA
ACTCACGCCTGAATCGAGT -> CTCACGCCTGAATCGAGTA
GTTTGCCAGTAAGAGCGAC -> TTTGCCAGTAAGAGCGACA
TACTGACCTTCTTTTACGG -> ACTGACCTTCTTTTACGGC
ATTAGACTTGGCGCCTAGG -> TTAGACTTGGCGCCTAGGC
ACTGATCGAGCGCCATCAG -> CTGATCGAGCGCCATCAGT
CTCCGTGATCAAATCCCTA -> TCCGTGATCAAATCCCTAA
ACTCGTGGTACCAACAACA -> CTCGTGGTACCAACAACAA
GCCCTTGCAATTAGGATGA -> CCCTTGCAATTAGGATGAT
AGGCCTGCGCGAGTCGTCG -> GGCCTGCGCGAGTCGTCGA
TCAGAATGTGACGACTGAT -> CAGAATGTGACGACTGATC
GGAATTTGACAGTCCCGGC -> GAATTTGACAGTCCCGGCG
GAAGAAGTGTTCTCCGTGA -> AAGAAGTGTTCTCCGTGAT
GAGAGATATCAAGGGGCGC -> AGAGATATCAAGGGGCGCG
AAAAGAGTACCACGGCCTA -> AAAGAGTACCACGGCCTAA
GAAATCCCAACGGAATTTG -> AAATCCCAACGGAATTTGA
CAATCTCGTCAGATTCATC -> AATCTCGTCAGATTCATCT
CCTTCCAATCCGAGTGTTT -> CTTCCAATCCGAGTGTTTC
TGAAGCTCAAGAACACAAG -> GAAGCTCAAGAACACAAGT
TTCGGCCCTGACTACACGA -> TCGGCCCTGACTACACGAA
GGTACGTGTGAGTTGGACA -> GTACGTGTGAGTTGGACAG
TTGCATAACTCATCGAAGA -> TGCATAACTCATCGAAGAC
CTTTTACGGCTTCATACCC -> TTTTACGGCTTCATACCCC
GTATTCCACTGTTAGTTTC -> TATTCCACTGTTAGTTTCC
AGATACTGATCACAGAGTT -> GATACTGATCACAGAGTTG
ATATTATTCCTCGCCGGGG -> TATTATTCCTCGCCGGGGC
CGAGTGTTTCACCTTAGGT -> GAGTGTTTCACCTTAGGTC
AGTTGGACAGGGGCGCAGG -> GTTGGACAGGGGCGCAGGG
AAGTCTTTGTTAGTCCTAT -> AGTCTTTGTTAGTCCTATG
GGTGTACTGTCACGCCACT -> GTGTACTGTCACGCCACTA
ACTGATCACAGAGTTGGTA -> CTGATCACAGAGTTGGTAC
CCCGCCCTGGTATACACTA -> CCGCCCTGGTATACACTAA
GCCTGAATCGAGTAGCGGG -> CCTGAATCGAGTAGCGGGA
TGTACTGTCACGCCACTAC -> GTACTGTCACGCCACTACC
TCCCGGCGAGGCATTCTGT -> CCCGGCGAGGCATTCTGTA
AGTGTTTCACCTTAGGTCT -> GTGTTTCACCTTAGGTCTT
GTAAGCGAAAACCCGGATT -> TAAGCGAAAACCCGGATTA
ATCTATATTATTCCTCGCC -> TCTATATTATTCCTCGCCG
ACCCCAAGCCACTCCGTTT -> CCCCAAGCCACTCCGTTTG
GAATGTGACGACTGATCGA -> AATGTGACGACTGATCGAG
CCGCCCTGGTATACACTAA -> CGCCCTGGTATACACTAAC
CGCTGTAGAGGCAGTCATC -> GCTGTAGAGGCAGTCATCT
ACATAATCCCCACTTCGAA -> CATAATCCCCACTTCGAAC
CGCCTGAATCGAGTAGCGG -> GCCTGAATCGAGTAGCGGG
AGCGAAAACCCGGATTAAC -> GCGAAAACCCGGATTAACC
CTTTGATATCGCTTATATA -> TTTGATATCGCTTATATAC
AATGAACGTCGCATTCATA -> ATGAACGTCGCATTCATAA
GTTATCATTAACCGGTAAC -> TTATCATTAACCGGTAACC
AGCTGGTTCACTCATGAGT -> GCTGGTTCACTCATGAGTG
AAGCTCAAGAACACAAGTG -> AGCTCAAGAACACAAGTGA
TGACTCACGCCTGAATACA -> GACTCACGCCTGAATACAT
GGCTTCATACCCCTGAAGC -> GCTTCATACCCCTGAAGCT
GTCGTCGAACTGGTTTCCG -> TCGTCGAACTGGTTTCCGT
ACTGTTAGTTTCCCGCCGT -> CTGTTAGTTTCCCGCCGTA
AGTCTGCTTTGCGGAGCCA -> GTCTGCTTTGCGGAGCCAT
GCCTGTTTCGCGATTCACG -> CCTGTTTCGCGATTCACGC
TTCGATCTTAATTATCAGT -> TCGATCTTAATTATCAGTG
AACTGAGGCCTCACTAACT -> ACTGAGGCCTCACTAACTT
GCAACCCGCCTAGCATATT -> CAACCCGCCTAGCATATTA
GGGTGGAATTTCACTACAC -> GGTGGAATTTCACTACACG
TATCGAATTCTAACTGAAA -> ATCGAATTCTAACTGAAAT
GCTTTGCGGAGCCATTGCA -> CTTTGCGGAGCCATTGCAA
TAGCTAGTTGTTACGGAGC -> AGCTAGTTGTTACGGAGCG
AAACGCATCATATAGACTT -> AACGCATCATATAGACTTC
GCGCCGAGTCTTCCTATCG -> CGCCGAGTCTTCCTATCGA
CTCTCAAACCGGGGTCTAT -> TCTCAAACCGGGGTCTATA
TACGGCTTCATACCCCTGA -> ACGGCTTCATACCCCTGAA
GGGCGCTCCAGAGTCCGGT -> GGCGCTCCAGAGTCCGGTA
CGAACTGCAACCCGCCTAG -> GAACTGCAACCCGCCTAGC
TCAGATTCATCTAGGCCAA -> CAGATTCATCTAGGCCAAT
AGGGATTGTCAGGCTACCG -> GGGATTGTCAGGCTACCGA
ACTCATGAGTGAGCTGGCC -> CTCATGAGTGAGCTGGCCT
GTGAGCTGGCCTATCGAAT -> TGAGCTGGCCTATCGAATT
CTAGGCGCTGGAGTCTGCT -> TAGGCGCTGGAGTCTGCTT
CGATTCTCTGAGCACCGTT -> GATTCTCTGAGCACCGTTG
ATGATTTCTGGACCGCCTA -> TGATTTCTGGACCGCCTAG
ACCCAGAATCTGGCCTCTT -> CCCAGAATCTGGCCTCTTT
TTACATTGTTAGAGAGTTA -> TACATTGTTAGAGAGTTAT
CAAATCCCTGACTCACGCC -> AAATCCCTGACTCACGCCT
GCACGCGACCGGTAAAAGC -> CACGCGACCGGTAAAAGCT
AGGCAATGCCTGTTTCGCG -> GGCAATGCCTGTTTCGCGA
TAGTCTCGGTGGGTATTCC -> AGTCTCGGTGGGTATTCCA
ACAACAAAGCGCCGAGTCT -> CAACAAAGCGCCGAGTCTT
TAGACTTCTCCTGAATGAG -> AGACTTCTCCTGAATGAGT
ACCACGGCCTAACGCTATT -> CCACGGCCTAACGCTATTT
CGGTAAAAGCTGGTTCACT -> GGTAAAAGCTGGTTCACTC
AAGAACACAAGTGAGGAAG -> AGAACACAAGTGAGGAAGC
CACCTCTACTCATGAACAC -> ACCTCTACTCATGAACACC
ACATATGTCGCCACATTGG -> CATATGTCGCCACATTGGC
ACTCACGCCTGAATACATG -> CTCACGCCTGAATACATGT
AGGCGCTGGAGTCTGCTTT -> GGCGCTGGAGTCTGCTTTG
CCTCTCACCTGCCAGGGGG -> CTCTCACCTGCCAGGGGGA
GCAATCTCGTCAGATTCAT -> CAATCTCGTCAGATTCATC
ACGCATCATATAGACTTCT -> CGCATCATATAGACTTCTC,CGCATCATATAGACTTCTC,CGCATCATATAGACTTCTG,CGCATCATATAGACTTCTA
GTCTATACAAACACGCGTA -> TCTATACAAACACGCGTAG
GACAGGCCCTTGCAATTAG -> ACAGGCCCTTGCAATTAGG
AGTCCCGTCCCGGCGAGGC -> GTCCCGTCCCGGCGAGGCA
GACTTGGCGCCTAGGCAAT -> ACTTGGCGCCTAGGCAATG
ATCCCAAATGAACGTCGCA -> TCCCAAATGAACGTCGCAT
ACGTAGAGATCCCAAATGA -> CGTAGAGATCCCAAATGAA
CCCAGAATCTGGCCTCTTT -> CCAGAATCTGGCCTCTTTG
TTATGATGCTAAATGGTCG -> TATGATGCTAAATGGTCGG
TAACGAATCCAAAAGTTCT -> AACGAATCCAAAAGTTCTA
GTGTGAGTTGGACAGGGGC -> TGTGAGTTGGACAGGGGCG
GTACTGTCACGCCACTACC -> TACTGTCACGCCACTACCT
TCCTATGAGCGAAAAGGAC -> CCTATGAGCGAAAAGGACC
GAGTGAGCTGGCCTATCGA -> AGTGAGCTGGCCTATCGAA
TCTCCGTGATCAAATCCCT -> CTCCGTGATCAAATCCCTA
CCGCCTAGAGTCGTGCCGA -> CGCCTAGAGTCGTGCCGAA
AGACTTGGCGCCTAGGCAA -> GACTTGGCGCCTAGGCAAT
TTAGGTCTTAGCAATTACC -> TAGGTCTTAGCAATTACCT
AAACCCGGATTAACCAGGA -> AACCCGGATTAACCAGGAA
CCGCTTCAAGATATCGAGT -> CGCTTCAAGATATCGAGTC
GTCGTGCCGAACATAGTTC -> TCGTGCCGAACATAGTTCG
CGCCAGTTGCCGATGATCC -> GCCAGTTGCCGATGATCCG
CGCATACCTTTGGAGAGAT -> GCATACCTTTGGAGAGATA
AGTTAGTCAGTCCAGCAAA -> GTTAGTCAGTCCAGCAAAA
GAACATCATTGACAATTTG -> AACATCATTGACAATTTGC
CACTAACGAATCCAAAAGT -> ACTAACGAATCCAAAAGTT
TCTATACAAACACGCGTAG -> CTATACAAACACGCGTAGT
CGGTGAGGAACATCATTGA -> GGTGAGGAACATCATTGAC
ATATCGAGTCCCGTCCCGG -> TATCGAGTCCCGTCCCGGC
GGCGAGGCATTCTGTAACC -> GCGAGGCATTCTGTAACCT
CTGACTCACGTCCTGACTC -> TGACTCACGTCCTGACTCA
AGGGGCGCAGGGTGGAATT -> GGGGCGCAGGGTGGAATTT
GCATTAACCACGATTAGCC -> CATTAACCACGATTAGCCA
CGATGATCCGTAGTGCACT -> GATGATCCGTAGTGCACTC
GGGATACCCGAACCTAGGG -> GGATACCCGAACCTAGGGC
TAGTCATTAGATCGTAGTC -> AGTCATTAGATCGTAGTCG
TCTAGATCAAGATTCATGC -> CTAGATCAAGATTCATGCT
GACTCACGCCTGAATCGAG -> ACTCACGCCTGAATCGAGT
ATCGATAAGCACGGCGATG -> TCGATAAGCACGGCGATGC
CTGGCCTATCGAATTCTAA -> TGGCCTATCGAATTCTAAC
CCTGACTACACGAATCGGC -> CTGACTACACGAATCGGCG
GCGAAGGATAGCTAGTTGT -> CGAAGGATAGCTAGTTGTT
AACAAAGCGCCGAGTCTTC -> ACAAAGCGCCGAGTCTTCC
CCGGGGCGCTCCAGAGTCC -> CGGGGCGCTCCAGAGTCCG
GGTGATGGAGAAATTCGAT -> GTGATGGAGAAATTCGATC
TTATAGGATGTAAGCTTGT -> TATAGGATGTAAGCTTGTA
GTGTAGTCATTAGATCGTA -> TGTAGTCATTAGATCGTAG
GTGATCAAATCCCTAACCG -> TGATCAAATCCCTAACCGG
TTCCACTGTTAGTTTCCCG -> TCCACTGTTAGTTTCCCGC
TACCTCCGCGTGTAGTCAT -> ACCTCCGCGTGTAGTCATT
ACGGCGATGCGCTACTGAC -> CGGCGATGCGCTACTGACC
GCCAATTGCCCGTTGTTTG -> CCAATTGCCCGTTGTTTGC
GCCGATGATCCGTAGTGCA -> CCGATGATCCGTAGTGCAC
AACTCATCGAAGACTAGGT -> ACTCATCGAAGACTAGGTT
ATACAAACACGCGTAGTTA -> TACAAACACGCGTAGTTAC
GACGCATCATATAGACTTC -> ACGCATCATATAGACTTCT
AAAGAGTACCACGGCCTAA -> AAGAGTACCACGGCCTAAC
GTTCACTCATGAGTGAGCT -> TTCACTCATGAGTGAGCTG
CTATACAAACACGCGTAGT -> TATACAAACACGCGTAGTT
CAGTAACAAGGTTATGACG -> AGTAACAAGGTTATGACGT
TTATATACGGTTATCATTA -> TATATACGGTTATCATTAA
TCATGCTCCCTTCCAATCC -> CATGCTCCCTTCCAATCCG
CCTCCCACCTCTACTCATG -> CTCCCACCTCTACTCATGA
GAGTCTTCCTATCGATAAG -> AGTCTTCCTATCGATAAGC
CAAAATAGCATTGGTGATG -> AAAATAGCATTGGTGATGG
TCAGCATCGGTTACGACGT -> CAGCATCGGTTACGACGTA
CCGAGTCTTCCTATCGATA -> CGAGTCTTCCTATCGATAA
TTTATAGGATGTAAGCTTG -> TTATAGGATGTAAGCTTGT
TCACGCCTGAATTGTCAGA -> CACGCCTGAATTGTCAGAG
ATAGCTAGTTGTTACGGAG -> TAGCTAGTTGTTACGGAGC
GGCGCCTAGGCAATGCCTG -> GCGCCTAGGCAATGCCTGT
CCTTCTTTTACGGCTTCAT -> CTTCTTTTACGGCTTCATA
ATTATGATTTCTGGACCGC -> TTATGATTTCTGGACCGCC
AGGTCTAAACTGAGGCCTC -> GGTCTAAACTGAGGCCTCA
TAACCGGTATGTGTTACAT -> AACCGGTATGTGTTACATA
ATACATGTCGGCCTGACTC -> TACATGTCGGCCTGACTCA
CTAGATCAAGATTCATGCT -> TAGATCAAGATTCATGCTC
GCTACTGACCTTCTTTTAC -> CTACTGACCTTCTTTTACG
TGGTACCAACAACAAAGCG -> GGTACCAACAACAAAGCGC
TGGACTGTCCGTCTCTAGA -> GGACTGTCCGTCTCTAGAT
TTTGGAGAGATATCAAGGG -> TTGGAGAGATATCAAGGGG
AGATCAAGATTCATGCTCC -> GATCAAGATTCATGCTCCC
ATCATTGACAATTTGCTAG -> TCATTGACAATTTGCTAGC
TTCTCTGAGCACCGTTGAT -> TCTCTGAGCACCGTTGATG
ACGAATCCAAAAGTTCTAC -> CGAATCCAAAAGTTCTACG
GTCCTGACTCACGCCTGAA -> TCCTGACTCACGCCTGAAT
ATACTCCGGTGAGGAACAT -> TACTCCGGTGAGGAACATC
ACGCCACTACCTTTTTATA -> CGCCACTACCTTTTTATAG
ATTCTCTGAGCACCGTTGA -> TTCTCTGAGCACCGTTGAT
TTTTACGGCTTCATACCCC -> TTTACGGCTTCATACCCCT
CCCCGCCCTGGTATACACT -> CCCGCCCTGGTATACACTA
AATCTGGCCTCTTTGATAT -> ATCTGGCCTCTTTGATATC
TGTTACATAATCCCCACTT -> GTTACATAATCCCCACTTC
TCGCTTGGGGGGTCCTCTC -> CGCTTGGGGGGTCCTCTCA
CCTGACTCACGTCCTGACT -> CTGACTCACGTCCTGACTC
GCACGGCGATGCGCTACTG -> CACGGCGATGCGCTACTGA
GGAAAGATCTGTCAGTTAG -> GAAAGATCTGTCAGTTAGT
CAATTAGGATGATAAGACA -> AATTAGGATGATAAGACAA
TGTTGTAAAGGTCTAAACT -> GTTGTAAAGGTCTAAACTG
TGTGTGTGTGATTGAGCAC -> GTGTGTGTGATTGAGCACG
CACATTGGCGCTGTAGAGG -> ACATTGGCGCTGTAGAGGC
CTGTTAGTTTCCCGCCGTA -> TGTTAGTTTCCCGCCGTAA
AGTAAACGCATCATATAGA -> GTAAACGCATCATATAGAC
ATTAGCCAGTAGGCAGGTA -> TTAGCCAGTAGGCAGGTAA
GAGGCATTCTGTAACCTGA -> AGGCATTCTGTAACCTGAC
TATACACTAACGAATCCAA -> ATACACTAACGAATCCAAA
ACTGTCACGCCACTACCTT -> CTGTCACGCCACTACCTTT
TACATGTCGGCCTGACTCA -> ACATGTCGGCCTGACTCAC
CTCTCACCTGCCAGGGGGA -> TCTCACCTGCCAGGGGGAA
GTCCCGGCGTGGCGTTCAG -> TCCCGGCGTGGCGTTCAGC
TGATTTCTGGACCGCCTAG -> GATTTCTGGACCGCCTAGA
CATGTCGGCCTGACTCACG -> ATGTCGGCCTGACTCACGT
AATTGTCAGAGTAAACGCA -> ATTGTCAGAGTAAACGCAT
AAAAGGACCCTATCGCTTG -> AAAGGACCCTATCGCTTGC
TGTCACGCCACTACCTTTT -> GTCACGCCACTACCTTTTT
TGTCAGAGTAAACGCATCA -> GTCAGAGTAAACGCATCAT
CATCTAGGCCAATTGCCCG -> ATCTAGGCCAATTGCCCGT
GGATAGCTAGTTGTTACGG -> GATAGCTAGTTGTTACGGA
AGCGCTTACTCTGTCAACT -> GCGCTTACTCTGTCAACTG
TGATCAAATCCCTAACCGG -> GATCAAATCCCTAACCGGT
TCCGCCCGACAGGCCCTTG -> CCGCCCGACAGGCCCTTGC
CGCCATCAGTAACAAGGTT -> GCCATCAGTAACAAGGTTA
ATCGAGTCCCGTCCCGGCG -> TCGAGTCCCGTCCCGGCGA
CACTCCGTTTGTTGCATAA -> ACTCCGTTTGTTGCATAAC
TCATATAGACTTCTGAATC -> CATATAGACTTCTGAATCT
TTCATCTAGGCCAATTGCC -> TCATCTAGGCCAATTGCCC
TGCAAATCCCTGACTCACG -> GCAAATCCCTGACTCACGC
TCAAGAACACAAGTGAGGA -> CAAGAACACAAGTGAGGAA
CTGGCCTCTTTGATATCGC -> TGGCCTCTTTGATATCGCT
TACCACGGCCTAACGCTAT -> ACCACGGCCTAACGCTATT
TAGTGCACTCGTGGTACCA -> AGTGCACTCGTGGTACCAA
GAGCGCTTACTCTGTCAAC -> AGCGCTTACTCTGTCAACT
CACCTTAGGTCTTAGCAAT -> ACCTTAGGTCTTAGCAATT
CGCATTCATAAGAAAAAGA -> GCATTCATAAGAAAAAGAG
CGGCGAGGCATTCTGTAAC -> GGCGAGGCATTCTGTAACC
GTCGTACCTCCGCGTGTAG -> TCGTACCTCCGCGTGTAGT
AGTGCACTCGTGGTACCAA -> GTGCACTCGTGGTACCAAC
TTACGACGTAGAGATCCCA -> TACGACGTAGAGATCCCAA
CAATCCGAGTGTTTCACCT -> AATCCGAGTGTTTCACCTT
ATCAAATCCCTAACCGGTA -> TCAAATCCCTAACCGGTAT
TACTGTCACGCCACTACCT -> ACTGTCACGCCACTACCTT
CACGCGTAGTTACCCAGAA -> ACGCGTAGTTACCCAGAAT
AAGATCTGTCAGTTAGTCA -> AGATCTGTCAGTTAGTCAG
TACTCTGTCAACTGCGGGG -> ACTCTGTCAACTGCGGGGA
GCGGTGAGACCCATCGGGC -> CGGTGAGACCCATCGGGCT
GGCGCTGTAGAGGCAGTCA -> GCGCTGTAGAGGCAGTCAT
ACATCATTGACAATTTGCT -> CATCATTGACAATTTGCTA
GTACCTGTCTGTTCTCATG -> TACCTGTCTGTTCTCATGC
GGGGGGTCCTCTCACCTGC -> GGGGGTCCTCTCACCTGCC
CCTGGTATACACTAACGAA -> CTGGTATACACTAACGAAT
TGCTTTGCGGAGCCATTGC -> GCTTTGCGGAGCCATTGCA
CGGAGAGCCATTCCTTACA -> GGAGAGCCATTCCTTACAT
ATCACAGAGTTGGTACCTG -> TCACAGAGTTGGTACCTGT
GACTGTCCGTCTCTAGATC -> ACTGTCCGTCTCTAGATCA
TATATTATTCCTCGCCGGG -> ATATTATTCCTCGCCGGGG
GACGTAGCACAATGGGATA -> ACGTAGCACAATGGGATAC
AGGCAGGTAAGGCCTGCGC -> GGCAGGTAAGGCCTGCGCG
CCCAAATGAACGTCGCATT -> CCAAATGAACGTCGCATTC
CCGTAAGCGAAAACCCGGA -> CGTAAGCGAAAACCCGGAT
CGGTACCACCCCAAGCCAC -> GGTACCACCCCAAGCCACT
CCCGCCTAGCATATTAGAC -> CCGCCTAGCATATTAGACT
GAGGGATTGTCAGGCTACC -> AGGGATTGTCAGGCTACCG
TCTCCTGAATGAGTTCCAC -> CTCCTGAATGAGTTCCACC
GTAAGCTTGTATCCGCCCG -> TAAGCTTGTATCCGCCCGA
GAAAAGGACCCTATCGCTT -> AAAAGGACCCTATCGCTTG
TTTCGCGATTCACGCAGCA -> TTCGCGATTCACGCAGCAA
TGACTCACGCCTGAATCGA -> GACTCACGCCTGAATCGAG
GTCTCGGTGGGTATTCCAC -> TCTCGGTGGGTATTCCACT
GAGCGGATGGACTGTCCGT -> AGCGGATGGACTGTCCGTC
TAACTCATCGAAGACTAGG -> AACTCATCGAAGACTAGGT
GATCACAGAGTTGGTACCT -> ATCACAGAGTTGGTACCTG
CAGTCATCTAAGCTTGTGT -> AGTCATCTAAGCTTGTGTC
ACCCGGATTAACCAGGAAA -> CCCGGATTAACCAGGAAAG
TCGATCTTAATTATCAGTG -> CGATCTTAATTATCAGTGT
CTGAATGAGTTCCACCAAC -> TGAATGAGTTCCACCAACG
CCTGAAGCTCAAGAACACA -> CTGAAGCTCAAGAACACAA
GTAAAGGTCTAAACTGAGG -> TAAAGGTCTAAACTGAGGC
ATCCCTGACTCACGCCTGA -> TCCCTGACTCACGCCTGAA
GCGGATGGACTGTCCGTCT -> CGGATGGACTGTCCGTCTC
GTAAAAGCTGGTTCACTCA -> TAAAAGCTGGTTCACTCAT